Re, Gs, Gs, Gs, Gs, Gs, Gs, Hh, Hh, Hh, Hh, Hh, Hh, Hh, Hh, Gs, Gs^Fms, Gs, Gs^Fms, Hh, Gs, Gs, Gs, Wwg, Wwg, Wwg, Wwg, Gs^Fms, Gs, Gs^Fms, Gs, Gs, Hh, Gs, Gs, Re, Gs, Hh, Gs^Fms, Gs^Fms
Gs, Re, Re, Gs, Re, Gs, Gs, Gs, Ce, Gs, Gs, Hh, Hh, Gs^Efm, Gs, Gs^Efm, Gs, Gs^Fms, Gd^Vo, Hh, Hh, Gs^Fds, Hh, Gs^Efm, Wwrg, Wwg, Wwg, Wwg, Wwg, Gs, Gs^Fms, Gs, Gs^Efm, Hh, Gs^Efm, Re, Re, Gs^Efm, Gs^Fms, Gs^Fms
Gs^Fms, Gs, Gd^Vo, Re, Gs, Re, Gs, Ce, 1 Ke, Ce, Gs, Gd^Vo, Gs, Gs, Gs, Gs, Gs, Gs, Gs, Gs^Fms, Hh, Hh, Hh, Hh, Hh, Hh, Hh, Wwrg, Wwg, Wwg, Wwg, Gs^Fds, Gs^Fms, Gs^Efm, Gs^Fds, Gs, Re, Gs, Gs^Efm, Gs^Fms
Gs^Efm, Gs, Gs, Gs, Gs, Ce, 2 Ke, Gs, Re, Ce, Re, Gs, Gs, Gs^Efm, Gs, Gs, Gll^Fp, Gs, Gs, Gs^Efm, Gll^Fp, Hh, Gs^Fms, Hh, Hh, Hh, Hh, Hh, Hh, Wwg, Wwg, Wwg, Wwg, Hh, Hh, Gs, Gs, Re, Gs, Gs^Fms
Gs^Fms, Gs^Efm, Gs, Gs, Gs, Ce, Ce, Ce, Gs, Re, Gs, Re, Re, Gs, Gs, Gs, Gs, Gs^Fms, Gs^Fms, Gs, Gs, Gs^Fms, Gs^Fms, Gs, Gs^Fms, Gs^Fms, Gg^Ve, Gs^Fms, Wwf, Wwf, Cv, Gs^Fds, Gs^Fds, Wwg, Wwg, Hh, Gs, Re, Gs, Gs
Gll^Fp, Gll^Fp, Gs^Fms, Gs, Re, Gs, Gs, Gs, Gs, Gs, Gs, Gs, Gs, Re, Re, Gs, Gs, Gs^Fms, Gs^Fms, Gs, Gs, Gs, Gs^Efm, Gs^Fms, Gs^Fds, Gs^Fms, Gs, Gs^Fms, Wwf, Gs^Fds, Cv, Gs^Fds, Cv, Gs^Fds, Wwg, Gs^Fms, Gs, Re, Re, Re
Gs, Gs^Fms, Gs^Fms, Gs, Gs, Gs, Gs, Gs, Gs, Gs^Fms, Gs, Gs, Gs, Gs, Gs, Re, Re, Gs, Gs, Gs, Gs, Gs^Efm, Gs, Gs^Efm, Gs^Fms, Gs^Fms, Gs, Gs^Fms, Gs^Fms, Wwf, Re, 4 Kv, Gs^Fds, Cv, Wwg, Gs^Fds, Gs, Re, Gs^Efm, Gs^Fms
Gs^Fms, Hh, Gs, Gs, Gs^Fms, Gs^Fms, Gs^Fms, Gs, Gs^Fms, Gs, Gs^Fms, Gs^Fms, Gs^Fms, Gs, Gs, Gs, Gd^Vo, Re, Gs, Gs^Fms, Gs, Gs^Fds, Gs, Gs^Efm, Gs, Gs, Gs, Gs, Re, Re, Gs^Fms, Gg^Ve, Cv, Cv, Wwg, Gs, Re, Re, Gs, Gs
Hh, Hh, Gs, Gs^Efm, Hh, Gll^Fp, Hh, Gs^Fms, Hh, Gs^Fms, Hh, Gll^Fp, Gs, Gs, Gs, Gs, Gs, Re, Re, Gs, Gs, Gs, Gs, Gs, Gs, Gs, Gs, Gs^Efm, Re, Gs^Fms, Gs^Fms, Wwf, Wwf, Wwg, Wwg, Gs^Fms, Re, Hh, Gs^Fds, Gs
Hh, Hh, Gd^Vo, Hh, Gs^Fms, Hh, Gs^Fms, Gs^Fms, Hh, Hh, Gs^Fms, Gs^Fms, Gs^Efm, Gs, Gs, Gs, Gs, Gs, Gs, Re, Re, Gs, Re, Re, Re, Re, Re, Re, Gs, Re, Re, Gs^Fms, Gs^Fms, Wwg, Wwg^Bsb/, Re, Gs^Fds, Hh, Hh, Gs^Fms
Mm, Hh, Hh, Hh, Hh, Hh, Hh, Hh, Hh, Hh, Gs, Gs^Efm, Gs^Fms, Gs^Fms, Gs, Gs^Efm, Gs^Efm, Gs^Fms, Gs, Gs, Re, Re, Gs, Gs, Gs, Gs, Gs, Gs, Gs^Fms, Gs, Re, Re, Re, Re, Wwg, Wwg, Gs^Fms, Gs^Fms, Gg^Ve, Gs^Fms
Mm, Mm, Mm, Hh, Mm, Mm, Mm, Mm, Mm, Hh, Hh, Gs^Fms, Gs^Fms, Gs, Gs^Fms, Gs, Gs^Efm, Gs, Gs, Re, Gg^Ve, Gs, Gs, Gs, Gs^Fms, Gs^Fds, Gs^Fms, Gs^Fds, Gs^Fms, Gs^Fms, Re, Gg^Ve, Gs^Fms, Gs^Fms, Wwg, Wwg, Wwf, Wwf, Wwg, Wwg
Mm, Mm, Mm, Mm, Mm, Mm, Mm, Mm, Mm, Hh, Hh, Hh, Hh, Hh, Gs^Efm, Gs^Fms, Gs, Gs, Gs, Re, Re, Gs^Fms, Gs, Gs, Gs^Fms, Gs, Gs^Fms, Gs, Gs^Fds, Gs^Fms, Gs^Fms, Re, Re, Gs^Fms, Wwg, Wwg, Wwg, Wwg, Wwrg, Wwg
Mm^Xm, Mm, Mm, Mm, Mm, Mm, Mm, Mm, Mm, Hh^Vhh, Mm, Hh, Mm, Hh, Hh, Gs^Fms, Gs^Fms, Gs^Fms, Gs^Fms, Gs, Gs^Efm, Re, Gs, Gs^Efm, Gs, Gs^Fds, Gs^Fds, Gs, Gs^Fms, Gs, Gs, Gs^Fms, Wwg, Wwg^Bsb\, Wwg^Bsb\, Wwg, Gs^Fms, Hh, Hh, Hh
Mm^Xm, Mm^Xm, Mm^Xm, Mm, Mm^Xm, Mm, Mm^Xm, Mm, Mm, Mm, Mm, Mm, Mm, Mm, Hh, Gs^Fms, Gs^Fms, Gs^Efm, Gs^Efm, Gs, Gs, Re, Gs^Fms, Gs^Fds, Gs, Gs, Gs^Fds, Gs^Fms, Gs^Fds, Gs^Fds, Wwf, Wwg, Wwg, Wwg, Gs^Fms, Re, Gs^Fms, Gs^Fms, Gs^Fms, Hh
Mm^Xm, Mm^Xm, Mm^Xm, Mm^Xm, Mm^Xm, Mm^Xm, Mm^Xm, Mm^Xm, Mm^Xm, Mm^Xm, Mm^Xm, Mm, Mm, Mm, Chr, Hh, Gs^Fms, Gll^Fp, Hh, Gs, Gs, Re, Gs^Fms, Gs^Fds, Gs^Fds, Gs^Efm, Gs, Gs, Gs, Gs^Fds, Wwg, Wwg, Gs^Fds, Gs^Fms, Gs^Fds, Re, Re, Gs^Fms, Gg^Ve, Hh
Mm^Xm, Mm^Xm, Mm^Xm, Mm^Xm, Mm^Xm, Mm^Xm, Mm^Xm, Mm^Xm, Mm^Xm, Mm^Xm, Mm^Xm, Mm^Xm, Mm, Mm, Chr, Khr, Chr, Chr, Hh, Gs^Fds, Re, Re, Gs^Fms, Gs^Fds, Gs^Fds, Gs^Efm, Gs, Gs, Gs^Fds, Gs, Wwg, Wwg, Gs^Fms, Gs^Fms, Gs^Fms, Gs^Fms, Gs, Re, Gs^Fms, Gs^Fms
Mm^Xm, Mm^Xm, Mm, Mm^Xm, Mm, Mm^Xm, Mm, Mm, Mm, Mm^Xm, Mm^Xm, Mm^Xm, Mm^Xm, Mm, Mm, Chr, Mm, Mm, Hh, Gs, Re, Gg^Ve, Gs^Fds, Gs^Fds, Gs, Gs, Gs, Gs^Fds, Gs^Fds, Gs^Efm, Wwg, Wwg, Gs^Fds, Gg^Ve, Gs, Gs^Efm, Gs^Fms, Re, Gs^Fms, Gs^Fms
Mm^Xm, Mm, Mm, Mm, Mm, Mm, Mm, Mm, Hh, Mm, Mm, Mm^Xm, Mm, Mm^Xm, Mm, Mm, Mm, Mm, Hh, Gs^Fds, Re, Gs^Fms, Gs^Fms, Gs^Efm, Gs, Gs, Gs^Fds, Gs, Gs^Fds, Gs^Fds, Wwg, Wwg, Gs^Fms, Gs^Fds, Gg^Ve, Gs^Efm, Gs^Fms, Re, Gs^Efm, Gs^Fms
Mm, Mm, Mm, Mm, Hh, Mm, Mm, Hh, Gs^Fms, Hh, Hh, Mm, Mm, Mm, Mm, Mm, Hh, Hh, Gs^Fms, Hh, Gs^Fds, Re, Gs^Fds, Gs, Gs, Gs^Fds, Gs^Fds, Gs^Fds, Wwg, Wwg, Wwg, Wwrg, Gs^Fds, Gs^Fms, Gs^Fds, Gs^Fms, Gs^Fms, Re, Gs^Fms, Gs^Fds
Mm, Mm, Hh, Hh, Gs^Fds, Hh, Hh, Hh, Gs^Fms, Gs^Fms, Gs^Fms, Hh, Hh, Mm, Mm, Mm, Hh, Gs^Fds, Gs^Efm, Gs, Re, Re, Re, Gs, Gs, Gs^Fds, Wwg, Wwg, Wwg, Wwg, Gs^Efm, Wwf, Wwf, Gs^Fms, Gs, Gs, Gs^Efm, Re, Gs^Fds, Gs^Fms
Mm, Mm, Hh, Cv, Cv, Cv, Gs^Fds, Gs^Fms, Gs^Efm, Gs^Fms, Gs, Gs^Fms, Gs^Fms, Hh, Hh, Mm, Hh, Gs, Re, Re, Gs, Gs^Fms, Gs^Fms, Re, Re, Wwg, Wwg, Wwg, Gs^Fms, Gs^Fms, Gs^Efm, Gs^Fms, Gs^Fds, Wwf, Wwf, Gs^Fms, Re, Re, Re, Gs^Fms
Hh, Hh, Gg^Ve, Gs^Fds, 5 Kv, Gs^Fms, Gs, Gs^Fms, Gs^Fms, Gg^Ve, Gs^Fms, Gs^Fms, Gs^Fms, Gs^Fds, Hh, Hh, Hh, Gs^Fms, Re, Gs, Gs^Fds, Gs^Fms, Gs^Fms, Gs^Fms, Wwg, Wwg^Bsb\, Wwg^Bsb\, Gs^Efm, Cv, Cv, Gg^Efm, Cv, Cv, Gs^Fds, Rr, Wwg^Bsb/, Gs, Gs^Fds, Re, Gs^Fms
Mm, Hh, Gs^Fms, Cv, Cv, Re, Re, Gs^Fms, Gs, Gs, Re, Gs^Fms, Gs, Gs^Fms, Gs^Fms, Hh, Hh, Gs^Fms, Re, Gs^Fms, Gs^Fms, Hh, Hh, Gs^Fms, Wwg, Wwg, Gs^Efm, Gs^Efm, Gg^Fet, Gg^Ve, Cv, Gg^Ve, Gg^Fet, Gs^Efm, Gs^Fds, Wwf, Gs^Fds, Gs, Re, Gs
Mm, Mm, Hh, Gs^Fds, Cv, Gs^Fms, Gs^Fms, Re, Re, Re, Gs^Efm, Re, Re, Gs^Fds, Gs, Gs^Fds, Gs^Efm, Gs, Re, Gs, Gs^Fms, Gs, Hh, Gs^Fds, Wwg, Wwg, Gs^Fms, Cv, Gg^Ve, Cv, 3 Kv, Cv, Gg^Ve, Cv, Gs^Fms, Wwf, Gs^Fms, Gs^Efm, Re, Gs^Efm
Mm, Mm, Mm, Hh, Hh, Gs^Fms, Gs^Fms, Gs^Efm, Gs, Gs^Fms, Gs^Fms, Gs^Efm, Gs^Fms, Re, Re, Re, Re, Re, Re, Gg^Ve, Gs^Fms, Hh, Gs^Fds, Gs^Fds, Wwg, Wwg, Gs^Efm, Cv, Gg^Fet, Cv, Cv, Cv, Gg^Fet, Cv, Gs^Fds, Wwf, Gs^Fds, Gs^Fds, Re, Gs^Efm
Mm, Mm, Mm, Mm, Mm, Gs^Fms, Gs^Fds, Gs^Fms, Gs^Fms, Gs^Fms, Gs^Fms, Gs^Fds, Gs^Fms, Gs^Fms, Re, Gs^Fms, Gs^Fms, Gs^Fms, Gs, Re, Re, Hh, Hh, Gs^Fms, Wwg, Wwg, Gs^Bsb/, Gs^Efm, Cv, Gg^Ve, Gg^Efm, Gg^Ve, Cv, Gs^Efm, Rr, Wwf, Gs, Gs^Fds, Re, Gs^Fds
Mm, Mm, Mm, Mm, Hh, Hh, Gs^Efm, Hh, Hh, Gs^Fds, Gs, Gs^Fms, Gg^Ve, Re, Gs^Efm, Gs, Gs^Fms, Gs^Fms, Gs^Fms, Hh, Hh, Re, Re, Gs^Fms, Re, Wwg^Bsb/, Wwg, Gs^Efm, Gs^Fms, Cv, Gs^Efm, Cv, Gs^Fds, Gs^Fds, Wwf, Wwg^Bsb\, Re, Gs^Fms, Re, Gs^Fds
Mm, Mm, Mm, Mm, Hh, Hh, Hh, Hh, Hh, Gs^Fms, Gs^Fms, Gs^Fms, Re, Re, Gs^Fms, Gs, Gs^Fms, Gs^Fds, Gs^Fms, Hh, Gs^Fds, Hh, Gs^Fms, Re, Gs^Fms, Wwg, Wwg, Wwg, Wwf, Gs^Fms, Wwf, Gs^Fms, Wwf, Wwf, Gs, Gs, Gs^Fms, Re, Re, Gs^Fms
Hh, Hh, Hh, Hh, Gs^Fms, Gs^Fms, Gs^Fms, Gs^Fms, Gs^Fms, Gs, Gs^Fms, Gs, Re, Gs, Gs^Fms, Gs^Fms, Gs, Gs, Gs, Gs^Fds, Hh, Hh, Hh, Hh, Gs^Fms, Gs^Fms, Wwg, Wwrg, Wwg, Wwf, Gs, Wwf, Gs, Gs^Efm, Gs^Fms, Gs^Fds, Gs^Fds, Gs^Fms, Re, Re
