Mm, Mm, Mm, Mm, Mm, Mm, Mm, Mm, Mm, Mm, Mm, Mm, Mm, Mm, Mm, Mm, Mm, Mm, Mm, Mm, Mm, Mm, Mm, Mm, Mm, Mm, Mm, Mm, Mm, Mm, Mm, Mm
Mm, Mm, Mm, Mm, Mm, Mm, Mm, Mm, Mm, Mm, Mm, Mm, Mm, Mm, Hh, Mm, Hh, Mm, Mm, Mm, Mm, Mm, Gs^Fds, Hh, Gs^Fds, Hh, Gs^Fms, Hh, Hh, Hh, Hh, Hh
Mm, Mm, Mm, Mm, Hh, Hh, Hh, Hh, Hh, Hh, Hh, Hh, Gs^Vh, Hh, Gg, Ch, Ch, Hh, Hh, Mm, Hh, Hh, Gg, Gs^Fds, Gs^Fms, Gs^Fms, Gs^Fms, Gs^Fms, Gs^Fds, Gs^Fms, Gs^Fms, Hh
Mm, Mm, Mm, Hh, Gs^Fds, Hh, Gs^Fds, Hh, Gs^Fms, Gs^Fms, Gs^Fds, Gg, Gg, Gg, Gg, Ch, 3 Kh, Ch, Hh, Hh, Hh, Gs^Fds, Gg, Gg, Gg, Gs^Vh, Gg, Gs^Fms, Gs^Fms, Gs^Fds, Gs^Fds, Gs^Fms
Mm, Mm, Hh, Hh, Gs^Fds, Gs^Fms, Gs^Fms, Gs^Fms, Gg, Gs^Fms, Gg, Gg, Gs^Fds, Gg, Gg, Ch, Ch, Ch, Ch, Hh, Hh, Gs^Fds, Gs^Fms, Gg, Gg, Gg, Gg, Gg, Gg, Gs^Fds, Gs^Fds, Gs^Fds
Mm, Mm, Hh, Gs^Fds, Gs^Fms, Gs^Fms, Gg, Gs^Fms, Gg, Gg, Gs^Fds, Gs^Fds, Gg, Gg, Re, Gg, Gg, Gg, Gs^Fds, Hh, Mm, Hh, Hh, Gs^Fms, Gs^Fds, Gg, Gg, Gs^Fms, Gg, Gs^Fms, Gs^Fds, Gs^Fds
Hh, Mm, Hh, Gs^Fds, Gs^Fms, Gs^Fms, Gg, Gg, Gg, Gs^Fds, Gs^Fds, Gg, Gg, Re, Gg, Gg, Gs^Fds, Gg, Gg, Hh, Mm, Mm, Mm, Hh, Hh, Gs^Fds, Gg, Gs^Fms, Gs^Fms, Gg, Gs^Fms, Gs^Fds
Hh, Hh, Gs^Fms, Gs^Fms, Gs^Fms, Gg, Gg, Gs^Fds, Gs^Fds, Gg, Gg, Gg, Gs^Vh, Re, Gg, Gs^Fds, Gs^Fds, Gs^Fds, Gg, Hh, Hh, Mm, Mm, Mm, Hh, Gs^Fds, Gs^Fms, Gg, Gs^Fms, Gg, Gs^Fms, Gs^Fms
Gs^Fms, Gs^Fms, Gs^Fms, Gs^Fms, Gg, Gg, Gs^Fds, Gs^Fds, Gg, Gg, Gg, Gg, Re, Re, Re, Gg, Gg, Gs^Fds, Gg, Gs^Fds, Hh, Mm, Mm, Mm, Hh, Gs^Fds, Gs^Fms, Gg, Gg, Gg, Gs^Vh, Gg
Gs^Fms, Gs^Fms, Gs^Vh, Gg, Gg, Gg, Gs^Fds, Gs^Fds, Gg, Gg, Re, Re, Gg, Gg, Gg, Re, Re, Gg, Gg, Gs^Fds, Gs^Fds, Hh, Hh, Mm, Mm, Hh, Gs^Fms, Gs^Fms, Gg, Gs^Fms, Gs^Fms, Gg
Gs^Fms, Gs^Fms, Gg, Gg, Gs^Fds, Gs^Fds, Gg, Gg, Re, Re, Gg, Gg, Gs^Fms, Gs^Fms, Gg, Gg, Gg, Re, Gs^Vh, Gg, Gg, Gs^Fds, Gs^Fds, Hh, Hh, Hh, Gs^Fms, Gg, Gg, Gg, Gs^Fms, Gs^Fms
Gs^Fms, Gs^Fms, Gg, Gg, Gs^Fds, Gs^Fds, Gg, Re, Gg, Gg, Gg, Gs^Fms, Gs^Fds, Gs^Fds, Gs^Fds, Gg, Gg, Re, Re, Gg, Gg, Gs^Fds, Gs^Fds, Hh, Gs^Fds, Hh, Gg, Gg, Gs^Fms, Gs^Fms, Gs^Fds, Gs^Fds
Gg, Gg, Gg, Gg, Gg, Gs^Fds, Gg, Re, Gg, Gg, Gs^Fms, Gs^Fms, Gs^Fds, Gs^Fds, Gs^Fms, Gs^Fds, Gs^Fds, Gg, Gg, Re, Gg, Gg, Gg, Gg, Gg, Gg, Gs^Fms, Gs^Fms, Gs^Fms, Gs^Fds, Gs^Fms, Gs^Fms
Gg, Gg, Gg, Gg, Gg, Gg, Re, Re, Gg, Gs^Fms, Gs^Fms, Gs^Fms, Gs^Fms, Gs^Fms, Gll, Gs^Fms, Gs^Fds, Gg, Gg, Re, Gg, Gg, Gs^Fds, Gg, Gg, Gg, Gs^Fms, Gs^Fms, Gs^Fds, Gs^Fms, Gs^Fms, Gs^Fms
Gg, Gg, Gg, Gg, Gs^Vh, Re, Gg, Gg, Gg, Gs^Fms, Gs^Fms, Gs^Fms, Gs^Fms, Gs^Fms, Sm, Gll, Gs^Fms, Gg, Gg, Re, Gg, Gs^Fds, Gs^Fds, Gg, Gg, Gs^Fms, Gs^Fms, Gs^Fms, Gs^Fms, Gs^Fms, Gs^Fms, Gg
Re, Gg, Re, Re, Re, Re, Gg, Gg, Gs^Fms, Gs^Fms, Gll, Gll, Wwg, Wwg, Wwg, Gll, Gs^Fms, Gg, Gg, Re, Gg, Gg, Gs^Fds, Gg, Gg, Gs^Fms, Gs^Fms, Gs^Fms, Gs^Fms, Gs^Vl, Gs^Fms, Gs^Fms
Gg, Re, Gg, Gg, Gg, Re, Gg, Gg, Gs^Fms, Gs^Fms, Gll, Sm, Wwg, Wwg, Sm, Rb, Gll, Gg, Gg, Re, Re, Gg, Gg, Gs^Fds, Gg, Gs^Fms, Gs^Fds, Gs^Fds, Gs^Fms, Gs^Fms, Gs^Fms, Gg
Gg, Gg, Gg, Gg, Gg, Re, Gg, Gg, Gs^Fms, Gs^Fms, Wwg, Wwg, Wwg, Gll, Ss, Rb, Gll, Gll, Gll, Gs^Vh, Re, Gg, Gg, Gg, Gg, Gs^Fms, Gs^Fms, Gs^Fds, Gs^Fds, Gs^Fms, Gs^Fms, Gs^Fms
Gs^Fds, Gg, Gg, Gg, Ce, Re, Ce, Gg, Gs^Fms, Gs^Fms, Wwg, Wwg, Rb, Ss, Wwg, Rb, Sm, Rb, Gll, Gg, Gg, Re, Re, Gg, Gg, Gs^Fms, Gs^Fms, Gs^Fms, Gs^Fms, Gs^Fds, Gg, Gs^Fms
Gs^Fds, Gs^Fms, Gs^Fms, Gg, Ce, 2 Ke, Ce, Gg, Gs^Fms, Gs^Fms, Wwg, Wwg, Ss, Sm, Ss, Sm, Ss, Rb, Gll, Gg, Gg, Gg, Gg, Re, Ce, Gg, Gg, Gs^Fms, Gs^Fds, Gs^Fds, Gs^Fms, Gs^Fms
Gs^Fms, Gs^Fds, Gs^Fms, Gg, Gg, Re, Re, Gg, Gs^Fms, Gs^Fms, Wwg, Wwg, Wwg, Rb, Sm, Gll, Ss, Rb, Gll, Gg, Gg, Gg, Gg, Ce, 1 Ke, Ce, Gg, Gs^Fms, Gs^Fms, Gs^Fds, Gs^Fms, Gs^Fds
Gs^Fms, Gs^Fds, Gs^Fms, Gs^Fms, Gs^Fms, Gg, Re, Gg, Gs^Fms, Wwg, Wwg, Wwg, Rb, Ss, Rb, Ss, Rb, Rb, Gll, Gs^Fms, Gs^Fms, Gg, Gg, Ce, Gg, Re, Re, Gg, Gg, Gs^Fms, Gs^Fms, Gs^Fms
Gg, Gs^Vl, Gs^Fms, Gs^Fms, Gs^Fms, Gg, Re, Gg, Wwg, Wwg, Wwg, Ss, Wwg, Sm, Gll, Wwg, Gll, Gll, Gs^Fms, Gs^Fms, Gg, Gs^Fms, Gs^Fms, Gg, Gg, Gg, Gg, Re, Re, Gg, Gg, Gs^Fms
Gg, Gs^Fms, Gg, Gs^Fms, Gg, Gg, Re, Gg, Wwg, Wwg, Wwg, Wwg, Gs^Fms, Gs^Fms, Gs^Fms, Gs^Fms, Gs^Fms, Gs^Fms, Gs^Fms, Gs^Fms, Gs^Fms, Gs^Fms, Gg, Gs^Fms, Gs^Fms, Gg, Gg, Gg, Gg, Re, Re, Gg
