Hh, Hh, Hh, Gs, Hh, Hh, Hh, Hh, Hh, Hh, Rb, Rb, Sm, Ss, Sm, Ss, Ss, Gs, Gs, Gs, Gs
Gs^Fds, Hh, Hh, Hh, Hh, Hh, Hh, Hh, Hh, Hh, Hh, Wwg, Ss, Ss, Ss, Ss, Wwrg, Ss, Gs, Gs, Gs
Hh, Gs^Fds, Gs^Fds, Gs^Fds, Ch, 3 Kh, Ch, Hh, Rr^Vhc, Hh, Hh, Wwg, Sm, Rb, Sm, Rb, Gll, Gll, Gs^Vc, Gs, Gs
Gs^Fds, Hh, Gs, Rr, Rr^Vhc, Ch, Rr, Rr, Rr, Gs, Gs, Gll^Fp, Rb, Rb, Gll, Gll, Gs, Gs, Gs, Gs, Re
Gs, Gs, Gs, Gs, Gs, Rr, Gs, Rr^Vhc, Gs, Gs, Gs, Gs, Gs, Gs, Gs, Gs, Re, Re, Re, Re, Gs
Re, Re, Re, Gs, Gs, Gs, Gs, Gs, Gs, Gs, Re, Re, Re, Re, Re, Re, Gs, Gs, Gs, Gs, Gs
Gs^Fds, Gs, Gs, Re, Re, Gs, Gs, Gs, Re, Re, Gs, Gs^Vh, Gs, Gs, Gs, Gs, Gs, Gs^Fms, Hh, Gs, Gs^Es
Gs, Gs^Fds, Gs^Vl, Gs, Gs, Re, Re, Re, Gs, Gs, Gs, Gs, Gs^Fds, Gs^Fds, Gs, Gs^Fds, Gs, Gs^Fds, Hh, Gs^Fds, Hh
Gs, Gs^Fds, Gs, Gs^Fds, Gs, Gs, Re, Gs, Gs, Gs, Gs^Es, Gs, Gs, Gs, Gs^Fds, Gs, Gs, Gs, Gs^Fds, Hh, Hh
Gs^Fms, Gs^Fms, Gs^Fds, Gs, Gs^Fms, Gs, Re, Gs, Gs, Gs^Fds, Gs^Fds, Gs^Fds, Gs^Fds, Gs^Fds, Gs^Fds, Gs, Gs^Fds, Gs, Gs, Gs^Fms, Gs^Fms
Gs^Fms, Gs^Fds, Gs^Fms, Gs^Fds, Gs^Fms, Gs, Re, Gs, Gs^Fds, Gs^Fds, Gs^Fds, Gs^Fds, Gs^Fds, Ww, Ww, Ww, Ww, Gs^Fds, Re^Gvs, Re^Eff, Re^Gvs
Gs, Gs, Gs, Gs, Gs, Gs, Re, Gs, Gs, Gs, Gs^Fds, Gs^Fds, Ww, Ww, Wwr, Ww, Ww, Ww, Re^Gvs, Re^Gvs, Re^Gvs
Re, Gs, Gs, Gs, Re, Re, Gs, Re, Re, Gs, Gs, Gs^Fds, Rr^Vhc, Rr^Vhc, Ch, 2 Kh, Ch, Ww, Re^Gvs, Re^Gvs, Re^Gvs
Gs, Re, Re, Re, Gs, Gs, Gs, Gs, Gs, Re, Re, Gs, Gs, Rr, Rr, Rr, Rr, Ww, Re^Gvs, Re^Gvs, Re^Gvs
Re, Gs, Re, Gs^Vh, Gs, Gs^Fds, Gs^Fds, Gs^Fds, Gs, Gs^Fds, Gs^Fds, Re, Re, Gs, Gs, Rr^Vhc, Gs, Re^Wm, Re^Gvs, Re^Gvs, Re^Gvs
Gs^Fds, Gs, Re, Gs, Gs, Gs^Fds, Gs^Fds, Gs^Fds, Gs^Fds, Gs, Gs, Gs, Gs, Re, Gs^Es, Gs, Gs^Fds, Gs, Gs, Gs, Gs
Gs^Fds, Gs, Re, Gs, Gs, Gs^Fds, Gs^Fds, Gs^Fds, Gs^Fds, Gs^Fds, Gs, Gs^Efm, Gs, Re, Re, Gs, Gs^Fds, Gs^Fds, Re, Re, Re
Gs^Fms, Gs, Gs, Re, Gs, Gs, Gs^Fds, Gs, Gs^Fds, Gs^Fds, Gs, Gs^Efm, Gs, Re, Gs^Fds, Re, Re, Re, Gs^Fds, Gs^Fds, Gs
Gs^Fms, Gs, Gs, Re, Gs, Gs, Gs^Fms, Gs^Fds, Gs^Fms, Gs, Gs^Fms, Gs, Gs^Vh, Re, Gs, Gs^Efm, Gs^Fds, Gs, Gs^Efm, Gs^Efm, Gs^Efm
Gs^Fds, Gs^Fds, Gs^Efm, Re, Re, Gs, Gs, Gs^Fms, Gs^Fds, Gs^Fds, Gs^Fds, Gs, Re, Re, Gs^Efm, Hh, Gs^Fds, Gs^Fms, Gs^Fds, Hh, Gs^Fds
Hh, Hh, Gs^Fms, Gs, Gs, Re, Re, Gs, Gs, Gs^Fds, Gs^Fds, Gs, Re, Gs, Gs^Fms, Hh, Hh, Hh, Hh, Hh, Gs^Fds
Hh, Hh, Gs^Fms, Gs^Fms, Gs, Gs, Gs, Re, Re, Gs, Gs, Gs, Re, Gs, Gs^Fds, Gs^Fms, Hh, Hh, Gs^Fds, Hh, Hh
Hh, Gs^Fds, Hh, Gs^Fds, Gs^Fds, Gs^Efm, Gs, Gs, Gs, Re, Re, Gs, Re, Gs, Gs, Gs^Fds, Gs^Fms, Gs^Fms, Gs, Gs^Efm, Hh
Hh, Gs^Fds, Gs^Fds, Gs^Vl, Gs^Fms, Gs^Fds, Gs, Gs^Fds, Gs, Gs, Gs, Re, Re, Gs^Es, Gs, Gs, Gs, Gs^Fms, Gs, Gs^Vl, Gs^Fds
Gs^Fms, Hh, Hh, Hh, Gs^Fms, Gs^Fds, Gs^Fds, Gs, Gs^Fds, Gs^Fds, Gs, Gs, Gs, Re, Re, Gs, Gs, Gs, Gs, Gs^Fms, Gs^Fms
Hh, Hh, Hh, Hh, Gs^Fds, Gs^Fms, Gs^Fds, Gs^Fms, Gs^Fms, Gs^Fms, Gs^Fds, Gs^Fds, Gs^Fds, Gs, Gs, 1 Re, Re, Gs, Gs, Gs^Fds, Gs^Fds
Hh, Hh, Gs^Fms, Gs^Fms, Gs, Gs^Fms, Gs^Fms, Gs^Fms, Gs^Fms, Gs^Fms, Gs^Fms, Gs^Fms, Re, Gs^Fds, Gs^Fds, Gs, Gs, Re, Re, Gs, Gs^Fds
