Hh, Hh, Hh, Hh, Hh, Hh, Mm, Mm, Mm, Mm, Hh, Mm, Mm, Mm, Mm, Mm, Mm, Mm, Mm, Mm^Xm, Xu, Xol, Xol, Xol, Xol, Xol, Xol, Cud, Cud, Cud, Xol, Xos, Xol, Xol, Xol, Xol, Xol
Gll^Fp, Gll^Fp, Gll^Fp, Hh, Gll^Fp, Hh, Gs^Fp, Hh, Hh, Hh, Gs^Fp, Hh, Hh, Mm, Mm, Mm, Mm, Mm, Xu, Xu, Xol, Xol, Xol, Xol, Urb, Urb, Cud, Cud, Kud, Cud, Cud, Urb, Urb, Xol, Xol, Xos, Xol
Gll^Fp, Gll^Fp, Gll^Fp, Gll^Fp, Gll^Fp, Gll^Fp, Gs^Fp, Gs^Fp, Gs^Fp, Gs^Fp, Gs^Fp, Gs^Fp, Gs^Fp, Mm, Mm, Mm, Mm, Xu, Xu, Xu, Uu, Xos, Xol, Xol, Urb, Ur, Irs, Cud, Irs, Cud, Irs, Ur, Urb, Xol, Xol, Urb, Uu
Gll^Fp, Gll^Fp, Gll^Fp, Gll^Fp, Gll^Fp, Gll^Fp, Gs^Fp, Gs^Fp, Gs^Fp, Gs^Fp, Gs, Gs^Fp, Gs, Gs, Rp, Hh, Ur, Hh^Ii, Urb^Ii, Cud, Ur, Uu, Xol, Xol, Xol, Ur, Ur, Irs, Irs, Irs, Ur, Ur, Xol, Xol, Xol, Uu, Ur
Gs, Gs, Gs, Gs, Gs, Gll^Fp, Gs, Gs, Gs, Gs, Gs, Gs, Rp, Rp, Rp, Rp, Ur, Urb^Ii, Uu^Ii, Urb, Urb, Ur, Ur, Xol, Xol, Urb, Urb, Ur, Ur, Ur, Urb, Urb, Xol, Xol, Urb, Ur, Uu
Rp, Gs, Rp, Rp, Rp, Gs, Rp, Rp, Rp, Gs, Rp, Rp, Gs, Gs, Mm, Hh, Mm, Hh, Xu, Cud, Uu, Urb, Urb, Ur, Xol, Xol, Xol, Urb, Urb, Urb, Xol, Xol, Xol, Xol, Ur, Ur, Xos
Gs, Rp, Gs, Gs, Gs, Rp, Gs, Gs, Gs, Rp, Gs, Gs, Gs, Mm, Mm, Mm, Mm, Xu, Xu, Uu, Uu, Ur, Urb, Ur, Uu, Xol, Xol, Urb, Urb, Urb, Xol, Xol, Ur, Ur, Urb, Uu, Xos
Hh, Gs, Gs, Gs, Hh, Gs, Hh, Gs, Gs^Fp, Gs, Gs^Fp, Gs, Gs^Fp, Mm, Mm, Mm, Mm, Xu, Xu, Xos, Xos, Ur, Urb, Ur, Ur, Uu, Ur, Urb, Ur, Urb, Uu, Ur, Ur, Xol, Xol, Xol, Xol
Hh, Hh, Gll^Fp, Gll^Fp, Hh, Hh, Gs^Fp, Hh, Hh, Gs^Fp, Hh, Gs^Fp, Gs^Fp, Gs^Fp, Mm, Mm, Mm, Mm, Xu, Xu, Xos, Uu, Ur, Urb, Urb, Urb, Urb, Urb, Uu, Uu, Ur, Xol, Xol, Ur, Ur, Uu, Ur
Gll^Fp, Hh, Hh, Gll^Fp, Gll^Fp, Gll^Fp, Gs^Fp, Gs^Fp, Hh, Gs^Fp, Hh, Gs^Fp, Gs^Fp, Mm, Mm, Mm, Mm, Mm, Xu, Xu, Xos, Uu^Vu, Ur, Xol, Xol, Urb, Ur, Uu, Xol, Xol, Xol, Xol, Xol, Urb, Ur, Ur, Uu
Hh, Hh, Hh, Gll^Fp, Hh, Gll^Fp, Mm, Hh, Hh, Hh, Hh, Gs^Fp, Mm, Mm, Mm, Mm, Mm, Mm, Xu, Xu, Xu, Xos, Xos, Ur, Ur, Xol, Ur, Ur, Ur, Xol, Uu, Xol, Ur, Ur, Xol, Xol, Xol
Hh, Hh, Gll^Fp, Hh, Mm, Mm, Mm, Mm, Hh, Gs^Fp, Hh, Mm, Mm, Mm, Mm, Mm, Mm, Mm^Xm, Xu, Xu, Xos, Xu, Xos, Uu, Urb, Ur, Uu, Xol, Xol, Ur, Ur, Ur, Uu, Xol, Xol, Xos, Xol
Hh, Mm, Mm, Mm, Mm, Mm, Mm, Mm, Mm, Mm, Mm, Mm, Mm, Mm, Mm, Mm, Mm, Mm^Xm, Mm^Xm, Xos, Xos, Xos, Xos, Urb, Ur, Ur, Uu, Xol, Uu, Xol, Uu, Ur, Uu, Uu, Urb, Xol, Xol
