Gs^Fds, Gs^Fds, Gs^Fms, Gs^Fds, Gs^Fms, Gs^Fds, Gs^Es, Gs^Fds, Gs, Gs, Gs, Gs, Gs, Gs, Re, Gs, Gs, Gs, Gs^Fms, Gs^Fds, Gs^Fms, Gs^Fms, Gs^Fds, Gs, Gs^Fds, Gs^Fms, Gs^Fms
Gs^Fds, Gs^Fms, Gs^Fds, Gs^Fms, Gs, Gs, Gs, Gs, Rb^Eff, Gs, Rp, Rp, Ch, Gs, Re, Gg, Gs, Gg, Gs, Gs^Fds, Gs^Fds, Gs^Fds, Gs^Es, Gs^Fms, Gs^Fms, Gs^Fds, Gs^Fms
Gs^Fds, Gs^Fms, Gs^Fds, Gg^Efm, Gs, Gs, Rb^Eff, Rb^Eff, Rb, Rb, Rp, Ch, Rr^Vhc, Rp, Re, Gs, Gs, Gs, Gg^Efm, Gs^Fds, Gs^Fms, Gs^Fms, Gs, Gs, Gs^Fds, Gs^Fds, Gs^Fms
Gs^Fds, Gs^Fms, Gs^Fms, Gs, Gs, Gs, Gs, Rb^Eff, Rb^Eff, Rb^Es, Rp, Rp, Rr, 3 Re, Rr^Vhc, Rp, Gs, Rp, Gs, Gs, Gg^Efm, Gs, Gs^Fms, Gs^Fds, Gs^Fds, Gs^Fds, Gs^Fms
Gs^Fds, Gs^Fds, Gs^Fds, Gs^Fds, Gg, Gs^Efm, Gs^Efm, Gs, Gs, Gs, Rp, Ch, Rp, Re, Rp, Ch, Gs, Gs, Gs, Gs, Gs, Gs, Gg, Gs^Fms, Gs^Fms, Gs^Fms, Gs^Fms
Gs^Fds, Gs^Fds, Gs^Fms, Gs^Fds, Gs^Fds, Gg, Gs^Fds, Gs, Gs^Fds, Gg^Efm, Gs^Fds, Gs, Gs^Es, Re, Gs, Gs, Gg^Efm, Gs, Gs^Fms, Gs^Fms, Gs^Fds, Gs^Fms, Gs^Fds, Gs^Fms, Gs^Fds, Gs^Fds, Gs^Fms
Gs^Fds, Gs^Fds, Gs^Fds, Gs^Fds, Gs^Fds, Gs^Fds, Gs^Fds, Gs^Fds, Gs^Fds, Gs^Fds, Gs^Fds, Gg^Efm, Gs, Re, Re, Gs, Gs, Gs^Fds, Gs, Gs^Fds, Gs^Fds, Gs^Fds, Gs^Fds, Gs^Fds, Gs^Fds, Gs^Fms, Gs^Fms
Gs^Fms, Gs^Fds, Gs^Fms, Gs^Fds, Gs^Vl, Gs^Fds, Rb^Edb, Gs^Fds, Gs^Fds, Gs^Fds, Gg^Efm, Gs^Efm, Gs^Fds, Gs, Gs, Re, Gs, Gs^Fds, Gs^Fds, Gs^Fms, Gs^Fms, Gs^Fds, Gs^Fms, Gs^Fms, Gs^Fds, Gs^Fds, Gs^Fms
Gs^Fds, Gs^Fds, Gs^Fms, Gs^Fds, Gs^Es, Gs, Gg, Gg, Gg^Efm, Gs, Gs^Fds, Gs, Gs^Fds, Gs^Fds, Gs, Re, Gs, Gs, Gg, Gs^Fms, Gs, Gs, Re, Gs, Gs, Gs^Fds, Gs^Fms
Gs^Fds, Gs^Fds, Gs^Fms, Gs^Fds, Gs, Gg, Ww, Ww, Ww, Gg, Gs, Gs^Fds, Gs, Gs^Fds, Gs, Re, Re, Gs^Fds, Gs^Fds, Gs^Fms, Gs, Gs^Fms, Gs^Fms, Re^Ecf, Gs^Em, Gs^Fds, Gs
Gs^Fds, Gs^Fds, Gs^Fds, Gs^Fds, Gs^Fds, Gg, Gg^Efm, Ww, Ww, Gg^Efm, Gg^Efm, Gg, Gg^Efm, Gs, Gs, Gg^Efm, Gs, Re, Gs, Gs, Gs^Fds, Gs^Fms, Gs^Fds, Gs^Fms, Gs^Fds, Gs^Fms, Gs^Fms
Gs^Fds, Gs^Fms, Gs^Fms, Gs^Fds, Gs^Fds, Gg, Gg^Efm, Ww, Ww, Ww, Ww, Gs^Fds, Gs^Fds, Gs^Fds, Gs^Fms, Gs^Fds, Gs^Fds, Gs, Re, Gs, Gs^Fds, Gs, Gs^Fms, Gs^Fms, Gs^Fds, Gs^Fds, Gs
Gs^Fds, Gs^Fds, Gs^Fms, Gs^Fds, Gs^Fds, Gg, Gs^Fds, Gs^Fds, Gs^Fms, Gg^Efm, Gs^Fds, Gg^Efm, Gs^Fms, Gs^Fms, Gs^Fms, Gs^Fms, Re, Gs, Re, Gs, Gs, Gs, Gs, Gs^Fms, Gs^Fms, Gs^Fds, Gs
Gs, Gs^Fds, Gs^Fds, Gs^Fds, Gs^Efm, Gs, Gs^Fms, Gs^Fds, Gs^Fms, Gs^Fms, Gs^Fms, Gs^Fds, Gs^Fds, Gs^Fds, Gs, Re, Gs, Re, Gs, Re, Re, Gg^Efm, Gg, Gs^Fds, Gs^Fms, Gs^Fms, Gs
Gs, Gs, Gs^Em, Gs^Fds, Gs^Fds, Gg, Gs, Gs^Fds, Gs^Fds, Gs^Fds, Gs^Fds, Gs^Fds, Gs^Fds, Gs^Fds, Gs^Fds, Re, Gs, Gs, Gs, Gs, Re, Gs^Fds, Gs, Gs, Gg, Gs^Fds, Gs^Fms
Re, Gs, Gs, Gs^Fds, Gs, Gg, Gs, Gs, Re, Gs^Fds, Gs, Gs^Fds, Gs^Fds, Gs^Fds, Re, Gs, Gs^Fms, Gs^Fds, Gs^Fds, Gs, Gs, Re, Re, Gs^Fds, Gs^Fds, Gs^Fms, Gs^Fds
Gs, Re, Re, Re, 2 Re, Gs, Re, Re, Gs, Re, Re, Gs^Fds, Gs, Re, Gg^Efm, Gs, Gs^Fds, Gs^Fms, Gs^Fms, Gs^Fds, Gg^Efm, Gs, Gs, Re, Gs, Gs^Fds, Gs^Fms
Hh, Gs, Gs, Gs, Gs, 1 Re, Gs, Gs, Gs^Fms, Gs^Fms, Gs^Fds, Re, Gs^Fds, Gs, Gs^Fds, Gs^Fms, Gs^Fds, Gs^Fds, Gs^Fds, Gs^Fds, Gs, Gs^Fds, Gs, Re, Gs^Fds, Gs^Fds, Gs^Fds
Hh, Hh^Es, Hh, Gs, Gs, Re, Re, Gs, Gs^Fms, Gs^Fms, Gs^Fds, Gs^Fds, Gs^Fds, Gs^Fds, Gs^Fds, Gs^Fms, Gs^Fms, Gs^Fds, Gs, Gs, Gs, Gs, Re, Gs, Gs^Vl, Gs^Fds, Gs^Fms
Hh, Hh^Es, Hh, Gs, Gg^Efm, Gs, Re, Gs, Gs^Fms, Gs^Fds, Gs^Fms, Gs^Fds, Gs^Fds, Gs^Fms, Gs^Fds, Gs^Fms, Gs^Fds, Gs^Fms, Gs^Fms, Gs, Gs, Re, Gs, Gs, Gs^Fds, Gs^Fms, Gs^Fds
Gs^Es, Hh, Hh, Gs, Gs, Gs, Re, Gs, Gs^Fms, Gs^Fms, Gs^Fms, Gs^Fds, Gs^Fds, Gs^Fds, Gs^Fds, Gs^Fds, Gs^Fms, Gs^Fds, Gs^Fms, Gg^Efm, Gs, Re, Gs, Gs^Fds, Gs^Fds, Gs^Fds, Gs
