Hh, Hh, Hh, Hh, Hh, Hh, Hh, Hh, Hh, Hh, Hh, Hh, Hh, Gs, Hh, Hh, Hh, Hh, Hh, Hh, Rb, Rb, Sm, Ss, Sm, Ss, Ss, Gs, Gs, Gs, Gg
Hh, Hh, Gs^Fds, Gs^Fds, Gs^Fds, Gs^Fds, Gg^Fds, Gs^Fds, Gg^Fds, Hh, Gs^Fds, Hh, Hh, Hh, Hh, Hh, Hh, Hh, Hh, Hh, Hh, Wwg, Ss, Ss, Ss, Ss, Wwrg, Ss, Gs, Gs, Gs
Hh, Gs^Fds, Gs^Fds, Gs^Fds, Gs, Gs^Fds, Gs, Gg^Fds, Gg, Gs^Fds, Hh, Gs^Fds, Gs^Fds, Gs^Fds, Gs^Fds, Hh, Ch, 4 Kh, Ch, Hh, Rr^Vhc, Wwg, Sm, Rb, Sm, Rb, Gll, Gll, Gs^Vc, Gs, Gs
Gs^Fds, Gs^Fds, Gg^Fds, Gs, Gs, Gs, Gs, Gs, Gg^Fds, Gg^Fds, Gs^Fds, Hh, Gg^Fds, Gg^Fds, Gs, Gs, Rr^Vhc, Rr, Rr, Rr, Rr, Gll^Fp, Rb, Rb, Gll, Gll, Gs, Gs, Gs, Gs, Re
Gg^Fds, Gg^Fds, Gs^Fds, Gs^Fds, Gs^Fds, Gs, Gs, Gs, Gs, Gg^Fds, Gs^Fds, Gg^Fds, Gs, Gg^Fds, Gs, Gs, Gs, Rr, Gs, Rr^Vhc, Gs, Gs, Gs, Gs, Gs, Gs, Re, Re, Re, Re, Gs
Gg^Fds, Gg^Fds, Gs^Fds, Gs^Fds, Rr^Vhc, Gs, Gs, Gs, Re, Gs, Gs, Gs, Re, Gs, Gs, Gs, Gs, Gs, Gs, Gs, Re, Re, Re, Re, Re, Re, Gs, Gs, Gs, Gs, Gs
Gs^Fds, Gs^Fds, 5 Kh, Ch, Rr, Rr, Re, Re, Gs, Re, Re, Re, Gs, Re, Re, Gs, Gs, Gs, Re, Re, Gs, Gs, Gs, Gs, Gs, Gs, Gs, Gs^Fms, Hh, Gs, Gs^Es
Gg^Fds, Gs^Fds, Ch, Rr, Re, Re, Gs, Gs, Gs^Fds, Gs, Gs^Vl, Gs, Gs, Gs, Gs, Re, Re, Re, Gs, Gs, Gs, Gs, Gs, Gs, Gs, Gs, Gg^Fds, Gs^Fds, Hh, Gs^Fds, Hh
Gs^Fds, Gg^Fds, Rr, Rr^Vhc, Re, Gs, Gs, Gs^Fms, Gg^Fms, Gs^Fds, Gg^Fds, Gs^Fds, Gs, Gs^Fds, Gs, Gs, Re, Gs, Gs, Gs, Gs^Es, Gs^Fds, Gg^Fds, Gs^Fds, Gs, Gs, Gs, Gs, Gg^Fds, Hh, Hh
Gs, Gg^Fds, Gs^Fds, Gs, Re, Gs, Gs, Gs, Gs^Fms, Gg^Fds, Gs^Fms, Gg^Fms, Gs^Fds, Gs, Gg^Fms, Gs, Re, Gs, Gs, Gs, Gs^Fds, Gs^Fds, Hh, Gg^Fds, Gs^Fds, Gs, Gs, Gs, Gs^Fds, Gg^Fms, Gs^Fms
Re, Gs, Gs, Gs, Re, Re, Re, Gs, Gs, Gs^Fds, Gs^Fms, Gs^Fds, Gs^Fms, Gg^Fds, Gs^Fms, Gs, Re, Gs, Gs, Gs, Gs^Fds, Gs^Fds, Hh, Gs^Fds, Gs, Gs, Gs, Gs, Gs^Fds, Hh, Hh
Gs, Re, Re, Re, Gs, Gs, Gs, Re, Re, Gs, Gs, Gs, Gs, Gs, Gs, Gs, Re, Gs, Gs, Gs, Gs, Hh, Gs^Fds, Hh, Gs^Fds, Gs, Gs, Gs^Fds, Gg^Fds, Hh, Hh
Gs^Fds, Gs, Gs, Gs, Gg^Fds, Gs^Fds, Gg^Fds, Gs, Gs, Re, Re, Gs, Gs, Gs, Re, Re, Gs, Gs, Gs, Gs, Gs^Es, Hh, Gs^Fds, Hh, Gg^Fds, Gs, Gg, Gs, Gs, Gs^Fds, Gs^Fds
Gs^Fds, Gs^Efm, Gs^Efm, Gs, Gs, Gg^Fds, Gs, Gs^Fds, Gs, Gs, Gs, Re, Re, Re, Gs, Gs, Gs, Gs, Gs, Gs^Fds, Gs^Fds, Gg^Fds, Gg^Fds, Gg^Fds, Gg^Fds, Gg^Fds, Gg^Fds, Gg, Gg, Gs^Fds, Gs^Fds
Gs^Fds, Gs^Fds, Gs^Fds, Gs^Efm, Gs^Fms, Gs, Gs^Fds, Gs, Gs, Gs, Gs^Efm, Gs, Re, Gs^Vh, Gs, Gs, Gs^Fds, Gs^Fds, Gg^Fds, Gg^Fds, Gs^Fds, Gg^Fds, Gg^Fds, Ww, Ww, Ww, Ww, Gg^Fds, Re^Gvs, Re^Eff, Re^Gvs
Hh, Gs^Fds, Hh, Gs^Fms, Hh, Gs^Fds, Gs^Fds, Gg^Fds, Gg^Fms, Gs, Gs, Gs, Re, Gs, Gs, Gs^Fds, Gg^Fds, Gg^Fds, Gs, Gs, Gg^Fds, Gg^Fds, Ww, Ww, Wwr, Ww, Ww, Ww, Re^Gvs, Re^Gvs, Re^Gvs
Hh, Hh, Hh, Hh, Gs^Fds, Gs^Fms, Hh, Gs^Fms, Hh, Gs^Fds, Gs, Gs, Re, Gs, Gs, Gs^Fds, Gs^Fds, Gs^Fds, Gs^Fds, Gs, Gs, Gg^Fds, Rr^Vhc, Rr^Vhc, Ch, 3 Kh, Ch, Ww, Re^Gvs, Re^Gvs, Re^Gvs
Gs^Fds, Gs^Fms, Gs^Fds, Hh, Gs^Fds, Gs^Fms, Hh, Hh, Gs^Fds, Gs^Fds, Gs, Gs, Gs, Re, Gs, Gs, Gg^Fds, Gs, Gs^Fds, Gs^Fds, Gs, Gs, Gs, Rr, Rr, Rr, Rr, Ww, Re^Gvs, Re^Gvs, Re^Gvs
Gs^Fds, Gs^Fms, Gs^Fds, Hh, Hh, Gs^Fms, Hh, Gs^Fms, Hh, Gs^Fds, Gs, Gs, Gs, Re, Gs, Gs, Gg^Fms, Gg^Fds, Gs^Fms, Gs, Gs^Fms, Gs, Gs, Re, Gs, Rr^Vhc, Gs, Re^Wm, Re^Gvs, Re^Gvs, Re^Gvs
Gs^Fds, Hh, Hh, Hh, Hh, Hh, Gs^Fms, Hh, Hh, Gs^Fms, Gs^Fds, Gs, Gs^Efm, Re, Re, Gs, Gs, Gg^Fms, Gs^Fds, Gs^Fds, Gg^Fds, Gs, Re, Re, Gs^Efm, Gs, Gs, Gs, Gs, Gs, Gs
Gs^Fds, Hh, Gs^Fds, Hh, Hh, Hh, Hh, Hh, Gs^Fms, Hh, Gs^Fds, Gs, Gs, Gs, Gs, Re, Re, Gs, Gs, Gs^Fds, Gg^Fds, Gs, Re, Gs, Gs^Fms, Gg^Fms, Hh, Gs^Fds, Hh, Gg^Fms, Gg^Fds
Gs^Fds, Gs^Fms, Gs^Fds, Gs^Fms, Hh, Hh, Hh, Gs^Fds, Hh, Hh, Hh, Hh, Gs^Fms, Gs, Gs, Gs, Gs, Re, Re, Gs, Gs, Gs, Re, Gs, Gs^Fds, Gg^Fms, Hh, Hh, Gs^Fds, Hh, Hh
Gs, Hh, Hh, Hh, Hh, Hh, Hh, Hh, Gs^Fds, Hh, Hh, Gs^Fds, Hh, Gs^Fds, Gs^Fds, Gs^Efm, Gs, Gs, Gs, Re, Re, Gs, Re, Gs, Gs, Gs^Fds, Gs^Vl, Gs^Fms, Gs, Gs^Efm, Hh
Gs^Fds, Hh, Hh, Hh, Gs^Fms, Hh, Gs^Fms, Gs^Fms, Hh, Gs^Fds, Hh, Gs^Fds, Gs^Fds, Gs^Vl, Gs^Fms, Gs^Fds, Gs, Gs^Fds, Gs, Gs, Gs, Re, Re, Gs^Es, Gs, Gs, Gs, Gs^Fms, Gs, Gs^Fds, Gs^Fds
Gs^Fds, Gs^Fms, Hh, Gs^Fds, Hh, Hh, Hh, Hh, Gs^Fms, Gs^Fds, Gs^Fms, Hh, Hh, Hh, Gs^Fms, Gs^Fds, Gs^Fds, Gs, Gs^Fds, Gs^Fds, Gs, Gs, Gs, Re, 1 Re, Gs, Gs, Gs, Gs, Gs^Fms, Gs^Fms
Hh, Hh, Hh, Hh, Hh, Hh, Hh, Gs^Fms, Hh, Hh, Hh, Hh, Gs^Fds, Hh, Gs^Fds, Gs^Fms, Gg^Fds, Gs^Fms, Gg^Fms, Gs^Fms, Gs^Fds, Gg^Fds, Gg^Fds, Gs, Gs, 2 Re, Re, Gs, Gs, Gs^Fds, Gs^Fds
Gs^Fds, Gs^Fds, Hh, Hh, Hh, Hh, Hh, Hh, Hh, Hh, Hh, Gs^Fds, Gs^Fms, Gs^Fms, Gs, Gs^Fms, Gs^Fms, Gs^Fms, Gs^Fms, Gg^Fms, Gs^Fms, Gs^Fms, Re, Gs^Fds, Gs^Fds, Gs, Gs, Re, Re, Gs, Gs^Fds
