Wwg, Wwg, Wwg, Wwg, Wwg, Wwg, Wwg, Wwg, Wwg, Gg, Gs, Gs, Re, Gs, Gs, Hh, Hh, Mm, Mm, Mm, Mm, Mm, Mm, Mm, Mm, Mm, Mm
Wwg, Wwg, Wwg, Wwg, Wwg, Wwg, Wwg, Wwg, Wwf, Gg, Re^Vh, Re, Re, Gs, Gs, Gs^Fds, Hh, Hh, Gs^Fds, Mm, 4 Kh, Hh, Rr^Vhc, Mm, Mm, Mm, Mm
Gg^Fds, Gg, Gg^Fds, Wwg, Gg^Fds, Wwg, Gg, Wwf, Wwf, Wwf, Gg, Gg, Gg, Re, Gs, Gs^Fms, Gs^Fds, Gs^Fms, Rp, Ch, Ch, Ch, Rr, Rr^Vhc, Hh, Mm, Mm
Hh, Gg^Fds, Gs^Fds, Gg, Gg, Gg, Gg, Gg, Wwrg, Wwg, Wwg, Gg^Efm, Gg^Efm, Re, Re, Gs, Gs, Rp, Rp, Rr^Vhc, Rr, Rr, Rr, Ch, 3 Kh, Mm, Mm
Hh, Hh, Gs^Fds, Gg, Gg, Gg, Hh, Hh, Hh, Wwg, Wwg, Gg, Gg, Gg^Fds, Gs^Fms, Re, Re, Rp, Rp, Rp, Rp, Rr, Rr, Ch, Ch, Mm, Mm
Hh, Gs^Fds, Gs^Fds, Gg, Gg, Gs^Fds, Hh, Hh, Mm, Wwrg, Wwg, Wwg, Rb^Gvs, Gg^Fds, Gs^Fms, Gs^Fds, Gs^Fds, Gs^Fds, Gs, Rp, Rp, Rp, Rp, Rr^Vhc, Rp, Hh, Mm
Hh, Gs^Fds, Gg, Gg, Gs^Fms, Gs^Fds, Hh, Mm, Mm, Gg^Fms, Wwg, Wwg, Rb^Gvs, Rb^Gvs, Re^Vh, Gs^Fms, Gs, Gs, Gs, Re, Gs, Rp, Gs, Rp, Gs^Fms, Hh, Gg^Fms
Gs^Fds, Gs^Fms, Gs, Gs, Re^Vh, Hh, Mm, Mm, Mm, Mm, Wwg, Wwg, Rb^Gvs, Rb^Gvs, Rb^Gvs, Rb^Gvs, Rb^Gvs, Rb, Gs^Es, Re, Gs, Gs, Re^Vh, Gs^Fds, Rb^Gvs, Gg^Fms, Gg^Fms
Gs^Fms, Gs, Gs, Re, Gs^Fds, Hh, Mm, Mm, Mm, Mm, Wwg, Wwg, Rb^Gvs, Rb^Gvs, Rb^Gvs, Rb^Gvs, Rb^Gvs, Rb^Gvs, Rb^Gvs, Re, Rb^Gvs, Rb^Gvs, Rb^Gvs, Rb^Gvs, Rb^Gvs, Rb^Gvs, Rb
Gs^Fms, Gs, Gs, Gs, Gs^Em, Hh, Hh, Mm, Mm, Mm, Wwrg, Wwg, Wwg, Rb^Gvs, Rb^Gvs, Rb^Gvs, Rb^Gvs, Rb^Gvs, Rb^Gvs, Re, Rb^Gvs, Rb^Gvs, Rb^Gvs, Rb^Gvs, Rb^Gvs, Rb^Gvs, Wwg
Gs^Fms, Gs, Gs, Gs, Gs, Gs^Fds, Gs^Fms, Hh, Hh, Hh, Hh, Wwg, Wwg, Wwg, Wwg, Wwg, Wwg, Rb^Gvs, Re, Re, Rb^Gvs, Rb^Gvs, Rb^Gvs, Rb^Gvs, Wwg, Wwg, Wwg
Gs, Gs, Gs, Gs, Gs, Gs, Gs^Fds, Gs^Fms, Gs^Fds, Hh, Gg^Fms, Gg^Fms, Gg, Wwg, Wwg, Wwg, Ww^Bsb/, Ww^Bsb/, Wwg, Wwg, Wwg, Wwg, Wwg, Wwg, Wwg, Wwg, Hh
Gs^Es, Gs, Gs, Gs, Gs, Gs, Gs^Fms, Gs^Fms, Gs^Fms, Gg^Fms, Gg^Fms, Gg, Gg, Gg, Re, Re, Rb^Gvs, Wwg, Wwg, Wwg, Wwg, Wwg, Wwg, Wwg, Hh, Hh, Hh
Gs^Fms, Gs^Fms, Gs, Gs, Gs, Gs, Gs, Gs^Fms, Gs^Fms, Gs^Fms, Gs, Gg, Gg, Gg, Re, Rb^Gvs, Rb^Gvs, Rb^Gvs, Rb^Gvs, Rb^Gvs, Re^Vwm, Gg^Fds, Gg^Fds, Gg^Fds, Hh, Hh, Hh
Hh^Em, Gs^Fds, Gs^Fms, Gs, Gs, Gs, Gs, Gs, Re^Vh, Gs^Fms, Gs, Gs, Gs, Gg, Re, Rb^Gvs, Rb^Gvs, Rb^Gvs, Rb^Gvs, Rb^Gvs, Rb^Gvs, Rb^Gvs, Gg^Fds, Gg^Fds, Gs^Fds, Hh, Hh
Hh, Hh, Gs^Fms, Gs, Gs^Es, Gs, Gs, Gs, Re, Gs^Fms, Gs, Gs, Gs, Gs, Re, Re, Re, Rb^Gvs, Rb^Gvs, Rb^Gvs, Rb^Gvs, Rb^Gvs, Gs^Fds, Gs^Fds, Gs^Fds, Gs^Fds, Hh
Hh, Hh, Gs^Fms, Gs, Gs, Gs, Gs, Gs, Gs, Gs, Gs, Gs, Re, Re, Gs, Gs, Gs, Re, Re, Rb^Gvs, Gs, Gs, Gs, Gs^Fds, Gs^Fds, Gs^Fds, Hh
Hh, Gs^Fds, Gs, Gs, Gs, Gs, Ce, Gs, Gs, Gs, Re, Re, Gs, Gs, Gs, Gs^Fds, Gs^Fds, Gs, Gs, Re, Re, Gs, Rr, Gs^Fds, Rr, Gs^Fds, Gs^Fds
Gs^Fms, Gs^Fms, Gs, Gs, Gs, Gs, 2 Ke, Ce, Re, Re, Gs, Gs, Gs, Gs, Gs^Fds, Gs^Fds, Gs^Fds, Gs, Gs, Gs, Rr^Vhc, Rr, Rr, Rr^Vhc, Rr, Gs^Fds, Gs^Fds
Gs^Fms, Gs, Gs, Gs, Gs, Ce, Re, Re, Ce, Gs, Gs, Gs, Gs, Gs^Fds, Gs^Fds, Gs^Fds, Gs^Fds, Gs^Fds, Gs^Fds, Gs^Fds, Gg, Rr, Rr^Vhc, Rr, Ww, Gg, Gs^Fds
Gs, Gs, Gs^Vh, Gs, Re, Re, Ce, 1 Ke, Ce, Gs, Gs, Gs, Gs, Gs, Gs^Fds, Gs^Fds, Gs^Fds, Gs^Fds, Gs^Fds, Gs^Fds, Gg, Ww, Ww, Ww, Ww, Ww, Gs^Fds
Gs, Gs, Re, Re, Gs, Gs, Gs, Gs, Gs, Gs, Gs, Gs, Gs^Fds, Gs^Vh, Gs^Fds, Gs^Fds, Gs^Fds, Gs^Fds, Gs^Fds, Gs^Fds, Gg, Ww, Ww, Ww, Ww, Gg, Gs^Fds
Re, Re, Gs, Gs, Gs, Gs, Gs, Gs, Gs, Gs^Fds, Gs^Fds, Gs^Fds, Gs^Fds, Gs^Fds, Gs^Fds, Gs^Fds, Gs^Fds, Gs^Fds, Gs^Fds, Gs^Fds, Gs^Fds, Gg, Gs^Fds, Gg, Gs^Fds, Gs^Fds, Gs^Fds
