Wwg, Wwg, Wwg, Wwg, Wwg, Wwg, Wwg, Wwg, Wwg, Gg, Gs^Fds, Gs^Fds, Hh, Mm, Mm, Mm, Mm, Mm, Hh, Mm, Mm, Mm, Hh, Mm, Mm, Hh, Hh
Wwg, Wwg, Wwg, Wwg, Wwg, Wwg, Wwg, Wwg, Wwf, Gg, Gs^Vh, Gs^Fds, Gs^Fms, Hh, Hh, Mm, Hh, Hh, Ch, Hh, Hh, Hh, Ch, Hh, Hh, Hh, Gs^Fms
Wwg, Wwg, Wwg, Wwg, Wwg, Wwg, Gg, Wwf, Wwf, Wwf, Gg, Gg, Gg, Gs^Fms, Gs^Fms, Gs^Fms, Gs^Fds, Gs^Fms, Gs, Ch, Kh, Ch, Gs^Vh, Gs^Fms, Hh, Gs^Fds, Hh
Hh, Wwg, Wwg, Wwg, Gg, Gg, Gg, Gg, Wwrg, Wwg, Wwg, Gg, Gg, Gs^Fds, Gs^Fds, Gs^Fds, Gs^Fms, Gs, Gs, Gs, Gs, Ch, Gs, Gs^Fds, Gs, Gs^Fds, Gs^Fds
Hh, Hh, Gs^Fds, Gg, Gg, Gg, Hh, Hh, Hh, Wwg, Wwg, Gg, Gg, Gg, Gs^Fms, Gs^Fms, Hh, Gs, Gs, Gs, 2 Gs, Gs, Gs, Gs, Gs, Gs, Gs
Hh, Gs^Fds, Gs^Fds, Gg, Gg, Gs^Fds, Hh, Hh, Mm, Wwrg, Wwg, Wwg, Rb^Gvs, Gg, Gs^Fms, Gs^Fds, Gs^Fds, Gs^Fds, Gs, Gs, Gs, Gs, Gs, Gs, Gs, Gs, Gs
Hh, Gs^Fds, Gg, Gg, Gs^Fms, Gs^Fds, Hh, Mm, Mm, Gs^Fms, Wwg, Wwg, Rb^Gvs, Rb^Gvs, Gs^Vh, Gs^Fms, Gs, Gs, Gs, Re, Gs, Gs, Gs, Gs, Gs^Fms, Gs, Gs^Fms
Gs^Fds, Gs^Fms, Gs, Gs, Gs^Vh, Hh, Mm, Mm, Mm, Mm, Wwg, Wwg, Rb^Gvs, Rb^Gvs, Rb^Gvs, Rb^Gvs, Rb^Gvs, Rb, Gs, Re, Gs, Gs, Gs^Vh, Gs^Fds, Rb^Gvs, Gs^Fms, Gs^Fms
Gs^Fms, Gs, Gs^Fds, Gs, Gs^Fds, Hh, Mm, Mm, Mm, Mm, Wwg, Wwg, Rb^Gvs, Rb^Gvs, Rb^Gvs, Rb^Gvs, Rb^Gvs, Rb^Gvs, Rb^Gvs, Re, Rb^Gvs, Rb^Gvs, Rb^Gvs, Rb^Gvs, Rb^Gvs, Rb^Gvs, Rb
Gs^Fms, Gs, Gs^Fms, Gs, Gs, Hh, Hh, Mm, Mm, Mm, Wwrg, Wwg, Wwg, Rb^Gvs, Rb^Gvs, Rb^Gvs, Rb^Gvs, Rb^Gvs, Rb^Gvs, Re, Rb^Gvs, Rb^Gvs, Rb^Gvs, Rb^Gvs, Rb^Gvs, Rb^Gvs, Wwg
Gs^Fms, Gs, Gs, Gs, Gs, Gs^Fds, Gs^Fms, Hh, Hh, Hh, Hh, Wwg, Wwg, Wwg, Wwg, Wwg, Wwg, Rb^Gvs, Re, Re, Rb^Gvs, Rb^Gvs, Rb^Gvs, Rb^Gvs, Wwg, Wwg, Wwg
Gs, Gs, Gs, Gs, Gs, Gs, Gs^Fds, Gs^Fms, Gs^Fds, Hh, Gs^Fms, Gs^Fms, Gg, Wwg, Wwg, Wwg, Ww^Bsb/, Ww^Bsb/, Wwg, Wwg, Wwg, Wwg, Wwg, Wwg, Wwg, Wwg, Hh
Gs, Gs, Gs, Gs, Gs, Gs, Gs^Fms, Gs^Fms, Gs^Fms, Gs^Fms, Gs^Fms, Gg, Gg, Gg, Re, Re, Rb^Gvs, Wwg, Wwg, Wwg, Wwg, Wwg, Wwg, Wwg, Hh, Hh, Hh
Gs^Fms, Gs^Fms, Gs, Gs, Gs, Gs, Gs, Gs^Fms, Gs^Fms, Gs^Fms, Gs, Gg, Gg, Gg, Re, Rb^Gvs, Rb^Gvs, Rb^Gvs, Rb^Gvs, Rb^Gvs, Re^Vwm, Gs^Fds, Gs^Fds, Gs^Fds, Hh, Hh, Hh
Hh, Gs^Fds, Gs^Fms, Gs, Gs, Gs, Gs, Gs, Gs^Vh, Gs^Fms, Gs, Gs, Gs, Gg, Re, Rb^Gvs, Rb^Gvs, Rb^Gvs, Rb^Gvs, Rb^Gvs, Rb^Gvs, Rb^Gvs, Gs^Fds, Gs^Fds, Gs^Fds, Hh, Hh
Hh, Hh, Gs^Fms, Gs, Gs, Gs, Gs, Gs, Gs, Gs^Fms, Gs, Gs, Gs, Gs, Re, Re, Re, Rb^Gvs, Rb^Gvs, Rb^Gvs, Rb^Gvs, Rb^Gvs, Gs^Fds, Gs^Fds, Gs^Fds, Gs^Fds, Hh
Hh, Hh, Gs^Fms, Gs, Gs, Gs, Gs, Gs, Gs, Gs, Gs, Gs, Re, Re, Gs, Gs, Gs, Re, Re, Rb^Gvs, Gs, Gs, Gs, Gs^Fds, Gs^Fds, Gs^Fds, Hh
Hh, Gs^Fds, Gs, Gs, Gs, Gs, Gs, Gs, Gs, Gs, Re, Re, Gs, Gs, Gs, Gs^Fds, Gs^Fds, Gs, Gs, Re, Re, Gs, Rr, Gs^Fds, Rr, Gs^Fds, Gs^Fds
Gs^Fms, Gs^Fms, Gs, Gs, Gs, Gs, Ce, Gs, Re, Re, Gs, Gs, Gs, Gs, Gs^Fds, Gs^Fds, Gs^Fds, Gs, Gs, Gs, Rr^Vhc, Rr, Rr, Rr^Vhc, Rr, Gs^Fds, Gs^Fds
Gs^Fms, Gs, Gs, Gs, Gs, Ce, 1 Ke, Re, Gs, Gs, Gs, Gs, Gs, Gs^Fds, Gs^Fds, Gs^Fds, Gs^Fds, Gs^Fds, Gs^Fds, Gs^Fds, Gg, Rr, Rr^Vhc, Rr, Ww, Gg, Gs^Fds
Gs, Gs, Gs^Vh, Gs, Re, Re, Ce, Ce, Gs, Gs, Gs, Gs, Gs, Gs, Gs^Fds, Gs^Fds, Gs^Fds, Gs^Fds, Gs^Fds, Gs^Fds, Gg, Ww, Ww, Ww, Ww, Ww, Gs^Fds
Gs, Gs, Re, Re, Gs, Gs, Gs, Gs, Gs, Gs, Gs, Gs, Gs^Fds, Gs^Vh, Gs^Fds, Gs^Fds, Gs^Fds, Gs^Fds, Gs^Fds, Gs^Fds, Gg, Ww, Ww, Ww, Ww, Gg, Gs^Fds
Re, Re, Gs, Gs, Gs, Gs, Gs, Gs, Gs, Gs^Fds, Gs^Fds, Gs^Fds, Gs^Fds, Gs^Fds, Gs^Fds, Gs^Fds, Gs^Fds, Gs^Fds, Gs^Fds, Gs^Fds, Gs^Fds, Gg, Gs^Fds, Gg, Gs^Fds, Gs^Fds, Gs^Fds
