Mm, Mm, Mm, Mm, Mm, Mm, Mm, Hh, Hh, Gs^Fms, Gs^Fms, Gs, Gs, Re, Gs, Gs, Gs^Fds, Gs^Fms, Gs^Fms, Gs^Fms, Gs^Fds, Gs^Fms, Gs^Fms, Gs^Fds, Gs^Fms, Gs^Fms, Gs^Fds, Gs^Fds, Gs^Fds, Gs^Fds, Gs^Fds, Gs^Fds, Gs, Gs, Gs, Gs, Gs
Mm, Mm, Mm, Mm, Hh, Hh, Hh, Gs^Fms, Gs^Fms, Gs^Fms, Gs^Fms, Gs, Gs, Re, Gs, Gs, Gs, Gs^Fms, Gs^Fms, Gs^Fms, Gs^Fds, Gs^Fms, Gs^Fds, Gs^Fds, Gs^Fds, Gs^Fds, Gs^Fds, Gs^Vl, Gs, Gs, Gs, Gs, Gs, Gs, Gs, Gs, Gs
Mm, Mm, Hh, Hh^Vhh, Gs^Fds, Gs^Fds, Hh, Hh, Gs^Fds, Gs^Fds, Gs^Fms, Gs^Fds, Gs, Re, Re, Gs, Gs, Gs, Gs, Gs^Fds, Gs^Fms, Gs^Fms, Gs, Gs^Fds, Gs, Gs^Fds, Gs, Gs, Gs, Gs, Gs, Gs, Ce, Ce, Ce, Re, Gs
Mm, Mm, Mm, Hh, Hh, Gs^Fds, Gs^Fds, Hh, Gs^Fds, Gs^Fds, Gs^Fds, Gs^Fds, Gs, Gs, Gs, Re, Re, Gs, Gs, Gs, Gs, Gs, Gs, Gs, Gs, Gs, Gs, Gs, Gs, Gs, Gs, Gs, Ce, 4 Ke, Ce, Gs, Gs
Mm, Mm, Mm, Mm, Hh, Hh, Hh, Gs^Fds, Hh, Gs^Fds, Gs^Fds, Gs^Fds, Gs, Gs, Gs, Gs, Gs, Re, Re, Gs, Re, Gs^Vh, Re, Re, Re, Gs, Gs, Gs, Gs, Gs, Re, Re, Gs, Ce, Gs, Gs, Gs
Mm, Mm, Mm, Mm, Hh, Hh, Gs^Fds, Hh, Gs^Fds, Hh, Gs^Fms, Gs^Fms, Gs, Gs, Gs^Fds, Gs, Gs^Fds, Gs, Gs, Re, Gs, Re, Gs, Gs, Gs, Re, Re, Gs, Re, Re, Gs, Gs, Gs, Gs, Gs, Gs, Gs^Fds
Mm, Mm, Mm, Mm, Mm, Hh, Hh, Gs^Fds, Gs^Fds, Gs^Fds, Gs^Fds, Gs^Vh, Gs, Gs, Gs^Fms, Gs^Fds, Gs^Fds, Gs^Fms, Gs^Fms, Gs, Hh, Gs, Hh, Gs, Gs^Fds, Gs, Gs, Re, Gs, Gs, Gs, Gs, Gs, Gs, Gs^Vh, Gs^Fds, Gs^Fms
Mm, Mm, Mm, Mm, Mm, Hh, Hh, Gs^Fds, Gs^Fds, Gs^Fms, Gs^Fds, Gs^Fms, Gs^Fms, Gs, Gs^Fds, Gs^Fds, Gs^Fms, Gs^Fds, Hh, Gs^Fms, Hh, Hh, Mm, Hh, Hh, Gs, Gs, Re, Gs, Gs, Gs, Gs, Gs^Fds, Gs, Gs^Fds, Gs^Fds, Gs^Fms
Mm, Mm, Mm, Mm, Mm, Mm, Mm, Hh, Hh, Gs^Fms, Hh, Hh, Hh, Gs^Fms, Gs^Fms, Gs^Fms, Gs, Gs^Fds, Hh, Hh, Hh, Mm, Mm, Mm, Hh, Gs^Fds, Gs, Re, Gs, Gs, Gs^Fds, Gs^Fds, Gs^Fds, Gs^Fds, Gs^Fds, Hh, Hh
Hh, Mm, Mm, Mm, Mm, Mm, Mm, Mm, Hh, Hh, Hh, Hh, Gs^Fms, Gs^Fds, Gs, Gs, Gs, Gs, Gs, Gs^Fds, Gs^Fds, Hh, Gs^Fds, Hh, Gs^Fds, Gs, Gs, Re, Gs, Gs, Gs, Gs^Fds, Gs^Fds, Gs^Fds, Hh, Hh, Hh
Hh, Hh, Hh, Mm, Mm, Mm, Mm, Mm, Hh, Hh, Hh, Gs^Fms, Gs^Fms, Gs^Vh, Gs, Gs, Gs, Gs, Gs, Gs, Gs, Gs^Fds, Gs, Gs^Fds, Gs, Gs, Gs, Re, Gs, Gs, Gs, Gs^Fds, Gs^Fms, Hh, Hh, Hh, Hh
Gs^Fds, Gs^Fds, Gs^Fds, Hh, Gs^Fds, Hh, Gs^Fds, Hh, Hh, Hh, Hh, Gs^Fds, Gs^Fms, Gs^Fms, Gs^Fms, Gs^Fds, Gs, Gs, Gs^Fds, Gs, Gs, Gs, Gs, Gs, Gs, Gs, Gs, Re, Gs, Gs, Gs, Gs^Fds, Gs^Fds, Hh, Hh, Hh, Hh
Gs, Gs, Gs, Gs^Fds, Gs, Gs^Fds, Gs^Fds, Hh, Gs^Fds, Hh, Mm, Hh, Gs^Fds, Gs^Fds, Gs^Fds, Gs^Fds, Gs^Fds, Gs^Fds, Gs^Fds, Gs^Fds, Gs^Fds, Gs^Fds, Gs^Fds, Gs, Gs, Gs, Gs, Re, Gs, Gs, Gs^Fds, Gs^Fms, Gs^Fds, Gs^Fds, Hh, Hh, Hh
Gg, Gs, Gg, Gs, Gg, Gs, Gs, Gs, Gg, Hh, Hh, Hh, Hh, Hh, Hh, Gs^Fds, Hh, Gs^Fds, Mm, Hh, Mm, Hh, Hh, Gs^Fds, Hh, Gs, Gs, Re, Re, Gs, Gs, Gs^Fms, Hh, Hh, Hh, Hh, Hh
Gg, Gg, Gg, Gg, Gg, Gg, Gg, Gg, Gg, Gs, Gs, Gs^Fds, Hh, Mm, Mm, Hh, Mm, Mm, Mm, Mm, Mm, Mm, Mm, Mm, Mm, Hh, Gs^Fds, Gs, Gs, Re, Gs, Gs^Vh, Hh, Hh, Hh, Hh, Hh
Wwg, Wwg, Wwg, Wwg, Wwg, Wwg, Wwg, Wwg, Wwg, Gg, Gs^Fds, Gs^Fds, Hh, Mm, Mm, Mm, Mm, Mm, Ch, Mm, Mm, Mm, Ch, Mm, Mm, Hh, Hh, Gs^Fds, Gs, Re, Gs, Gs, Hh, Hh, Hh, Gs^Fms, Hh
Wwg, Wwg, Wwg, Wwg, Wwg, Wwg, Wwg, Wwg, Wwf, Gg, Gs^Vh, Gs^Fds, Gs^Fms, Hh, Hh, Mm, Gs, 1 Kh, Ch, Hh, Ch, Hh, Ch, 2 Kh, Gs, Hh, Gs^Fms, Gs^Fms, Gs, Re, Gs, Gs^Fms, Gs^Fms, Gs^Fms, Gs^Fms, Gs^Fms, Hh
Wwg, Wwg, Wwg, Wwg, Wwg, Wwg, Gg, Wwf, Wwf, Wwf, Gg, Gg, Gg, Gs^Fms, Gs^Fms, Gs^Fms, Gs^Fds, Gs^Fms, Gs, Ch, Re, Ch, Gs^Vh, Gs^Fms, Hh, Gs^Fds, Hh, Gs, Gs, Re, Gs, Gs, Gs^Fds, Gs^Fds, Gs^Fms, Hh, Hh
Hh, Wwg, Wwg, Wwg, Gg, Gg, Gg, Gg, Wwrg, Wwg, Wwg, Gg, Gg, Gs^Fds, Gs^Fds, Gs^Fds, Gs^Fms, Gs, Gs, Gs, Re, Gs, Gs, Gs^Fds, Gs, Gs^Fds, Gs^Fds, Gs, Re, Re, Gs, Gs, Gs, Gs^Fms, Gs^Fms, Gs^Fms, Hh
Hh, Hh, Gs^Fds, Gg, Gg, Gg, Hh, Hh, Hh, Wwg, Wwg, Gg, Gg, Gg, Gs^Fms, Gs^Fms, Hh, Gs, Gs, Re, Gs, Re, Re, Gs, Gs, Gs, Re, Re, Gs, Gs, Gs^Fms, Gs^Fms, Hh, Gs^Fms, Gs^Fms, Gs^Fms, Hh
Hh, Gs^Fds, Gs^Fds, Gg, Gg, Gs^Fds, Hh, Hh, Mm, Wwrg, Wwg, Wwg, Rb^Gvs, Gg, Gs^Fms, Gs^Fds, Gs^Fds, Gs^Fds, Gs, Re, Gs, Gs, Gs, Re, Re, Re, Gs, Gs, Hh, Hh, Hh, Hh, Hh, Hh, Gs^Fms, Gs^Fms, Gg
Hh, Gs^Fds, Gg, Gg, Gs^Fms, Gs^Fds, Hh, Mm, Mm, Gs^Fms, Wwg, Wwg, Rb^Gvs, Rb^Gvs, Gs^Vh, Gs^Fms, Gs, Gs, Gs, Re, Gs, Gs, Gs, Gs, Gs^Fms, Gs, Gs^Fms, Hh, Hh, Hh, Hh, Hh, Gs^Fms, Gs^Fds, Gg, Gg, Ww
Gs^Fds, Gs^Fms, Gs, Gs, Gs^Vh, Hh, Mm, Mm, Mm, Mm, Wwg, Wwg, Rb^Gvs, Rb^Gvs, Rb^Gvs, Rb^Gvs, Rb^Gvs, Rb, Gs, Re, Gs, Gs, Gs^Vh, Gs^Fds, Rb^Gvs, Gs^Fms, Gs^Fms, Hh, Gg, Gg, Ww, Gg, Ww, Ww, Ww, Ww, Ww
Gs^Fms, Gs, Gs^Fds, Gs, Gs^Fds, Hh, Mm, Mm, Mm, Mm, Wwg, Wwg, Rb^Gvs, Rb^Gvs, Rb^Gvs, Rb^Gvs, Rb^Gvs, Rb^Gvs, Rb^Gvs, Re, Rb^Gvs, Rb^Gvs, Rb^Gvs, Rb^Gvs, Rb^Gvs, Rb^Gvs, Hh, Hh, Ww, Ww, Ww, Ww, Ww, Ww, Ww, Ww, Ww
Gs^Fms, Gs, Gs^Fms, Gs, Gs, Hh, Hh, Mm, Mm, Mm, Wwrg, Wwg, Wwg, Rb^Gvs, Rb^Gvs, Rb^Gvs, Rb^Gvs, Rb^Gvs, Rb^Gvs, Re, Rb^Gvs, Rb^Gvs, Rb^Gvs, Rb^Gvs, Rb^Gvs, Rb^Gvs, Wwg, Ww, Ww, Ww, Gg, Ww, Gg, Ww, Gg, Ww, Gg
Gs^Fms, Gs, Gs, Gs, Gs, Gs^Fds, Gs^Fms, Hh, Hh, Hh, Hh, Wwg, Wwg, Wwg, Wwg, Wwg, Wwg, Rb^Gvs, Re, Re, Rb^Gvs, Rb^Gvs, Rb^Gvs, Rb^Gvs, Wwg, Wwg, Wwg, Ww, Gg, Gg, Gg, Gg, Gg, Gg, Gs, Gg, Gs
Gs, Gs, Gs, Gs, Gs, Gs, Gs^Fds, Gs^Fms, Gs^Fds, Hh, Gs^Fms, Gs^Fms, Gg, Wwg, Wwg, Wwg, Ww^Bsb/, Ww^Bsb/, Wwg, Wwg, Wwg, Wwg, Wwg, Wwg, Wwg, Wwg, Hh, Gg, Gg, Gs^Fms, Gs^Fds, Gs^Fms, Gs^Fds, Gs^Fds, Hh, Hh, Hh
Gs, Gs, Gs, Gs, Gs, Gs, Gs^Fms, Gs^Fms, Gs^Fms, Gs^Fms, Gs^Fms, Gg, Gg, Gg, Re, Re, Rb^Gvs, Wwg, Wwg, Wwg, Wwg, Wwg, Wwg, Wwg, Hh, Hh, Hh, Gs^Fds, Gs^Fms, Gs^Fds, Gs^Fds, Gs^Fds, Gs^Fds, Gs^Fds, Hh, Hh, Hh
Gs^Fms, Gs^Fms, Gs, Gs, Gs, Gs, Gs, Gs^Fms, Gs^Fms, Gs^Fms, Gs, Gg, Gg, Gg, Re, Rb^Gvs, Rb^Gvs, Rb^Gvs, Rb^Gvs, Rb^Gvs, Re^Vwm, Gs^Fds, Gs^Fds, Gs^Fds, Hh, Hh, Hh, Hh, Hh, Hh, Hh, Gs^Fds, Hh, Gs^Fds, Gs^Fds, Hh, Gs^Fds
Hh, Gs^Fds, Gs^Fms, Gs, Gs, Gs, Gs, Gs, Gs^Vh, Gs^Fms, Gs, Gs, Gs, Gg, Re, Rb^Gvs, Rb^Gvs, Rb^Gvs, Rb^Gvs, Rb^Gvs, Rb^Gvs, Rb^Gvs, Gs^Fds, Gs^Fds, Gs^Fds, Hh, Hh, Hh, Hh, Hh, Hh, Hh, Hh, Hh, Gs^Fds, Gs^Fds, Gs^Fds
Hh, Hh, Gs^Fms, Gs, Gs, Gs, Gs, Gs, Gs, Gs^Fms, Gs, Gs, Gs, Gs, Re, Re, Re, Rb^Gvs, Rb^Gvs, Rb^Gvs, Rb^Gvs, Rb^Gvs, Gs^Fds, Gs^Fds, Gs^Fds, Gs^Fds, Hh, Hh, Hh, Gs^Fds, Gs^Fds, Gs^Fds, Hh, Hh, Hh, Hh, Hh
Hh, Hh, Gs^Fms, Gs, Gs, Gs, Gs, Gs, Gs, Gs, Gs, Gs, Re, Re, Gs, Gs, Gs, Re, Re, Rb^Gvs, Gs, Gs, Gs, Gs^Fds, Gs^Fds, Gs^Fds, Hh, Hh, Hh, Hh, Gs^Fds, Gs^Fds, Hh, Hh, Hh, Gs^Fds, Gs^Fds
Hh, Gs^Fds, Gs, Gs, Gs, Gs, Gs, Gs, Gs, Gs, Re, Re, Gs, Gs, Gs, Gs^Fds, Gs^Fds, Gs, Gs, Re, Re, Gs, Rr, Gs^Fds, Rr, Gs^Fds, Gs^Fds, Gs^Fds, Gs^Fds, Hh, Hh, Gs^Fds, Gs^Fds, Hh, Hh, Hh, Hh
Gs^Fms, Gs^Fms, Gs, Gs, Gs, Gs, Ce, Gs, Re, Re, Gs, Gs, Gs, Gs, Gs^Fds, Gs^Fds, Gs^Fds, Gs, Gs, Gs, Rr^Vhc, Rr, Rr, Rr^Vhc, Rr, Gs^Fds, Gs^Fds, Gs^Fds, Gs^Fds, Gs^Fds, Hh, Hh, Hh, Hh, Hh, Hh, Gs^Fds
Gs^Fms, Gs, Gs, Gs, Gs, Ce, 3 Ke, Ce, Gs, Gs, Gs, Gs, Gs, Gs^Fds, Gs^Fds, Gs^Fds, Gs^Fds, Gs^Fds, Gs^Fds, Gs^Fds, Gg, Rr, Rr^Vhc, Rr, Ww, Gg, Gs^Fds, Gs^Fds, Hh, Gs^Fds, Gs^Fds, Hh, Hh, Hh, Hh, Hh, Gs^Fds
Gs, Gs, Gs^Vh, Gs, Re, Ce, Ce, Ce, Gs, Gs, Gs, Gs, Gs, Gs, Gs^Fds, Gs^Fds, Gs^Fds, Gs^Fds, Gs^Fds, Gs^Fds, Gg, Ww, Ww, Ww, Ww, Ww, Gs^Fds, Gs^Fms, Gs^Fds, Hh, Hh, Gs^Fds, Hh, Hh, Gs^Fds, Gs^Fds, Gs^Fds
Gs, Gs, Re, Re, Gs, Gs, Gs, Gs, Gs, Gs, Gs, Gs, Gs^Fds, Gs^Vh, Gs^Fds, Gs^Fds, Gs^Fds, Gs^Fds, Gs^Fds, Gs^Fds, Gg, Ww, Ww, Ww, Ww, Gg, Gs^Fds, Gs^Fds, Gs^Fms, Hh, Hh, Hh, Hh, Hh, Gs^Fds, Gs^Fds, Hh
Re, Re, Gs, Gs, Gs, Gs, Gs, Gs, Gs, Gs^Fds, Gs^Fds, Gs^Fds, Gs^Fds, Gs^Fds, Gs^Fds, Gs^Fds, Gs^Fds, Gs^Fds, Gs^Fds, Gs^Fds, Gs^Fds, Gg, Gs^Fds, Gg, Gs^Fds, Gs^Fds, Gs^Fds, Gs^Fds, Gs^Fds, Gs^Fds, Gs^Fds, Hh, Hh, Gs^Fds, Gs^Fds, Hh, Gs^Fds
