Hh, Mm, Gs^Fds, Gs, Gs, Gs, Gs, Gs, Gs, Gs, Gs, Gs, Gs, Gs, Gs, Gs, Gs^Fds, Gs^Fms, Gs^Fms, Gs^Fms, Gs^Fds, Gs^Fms, Gs^Fms, Gs^Fds, Hh^Em, Hh, Hh, Mm, Mm, Mm, Mm, Mm, Mm, Mm, Mm, Mm, Mm
Hh, Hh, Gs^Efm, Gs, Gs, Gs, Gs, Gs, Gs, Gs, Gs, Gs, Gs, Gs, Gs, Gs, Gs, Gs^Fms, Gs^Fms, Gs^Fms, Gs, Gs^Fms, Gs^Fds, Gs^Fds, Gs^Fds, Gs^Fds, Gs^Fds, Hh, Hh, Mm, Mm, Mm, Mm, Mm, Mm, Mm, Mm
Mm, Hh, Hh^Em, Gs, Gs, Gs, Gs, Re, Re, Gs, Gs, Gs, Gs, Gs, Gs^Fds, Gs, Gs, Gs, Gs, Gs, Gs, Gs, Gs, Gs, Gs^Vl, Gs^Fds, Hh^Em, Hh, Gs^Fds, Hh, Mm, Mm, Mm, Mm, Mm, Mm, Mm
Hh, Hh, Hh, Gs^Fds, Gs^Fds, Gs, Gs, Gs, Re, Gs, Gs, Gs, Gs, Gs^Fds, Gs^Fds, Gs^Fds, Gs^Fds, Gs, Gs, Gs, Gs, Gs, Gs, Gs, Gs^Fds, Hh, Hh, Gs^Fds, Hh, Hh, Mm, Mm, Mm, 4 Mm, Mm, Mm, Mm
Mm, Hh^Es, Hh, Hh, Gs^Fds, Gs, Gs, Gs, Re, Gs, Gs, Gs^Fds, Hh, Hh, Gs^Fds, Hh, Hh, Gs, Gs, Gs, Gs, Gs, Gs, Gs, Gs^Fds, Hh, Gs^Fds, Gs^Fds, Hh, Hh, Mm, Mm, Mm, Mm, Mm, Mm, Mm
Mm, Mm, Hh, Hh, Hh, Gs^Fds, Gs, Gs, Re, Gs, Gs, Gs^Fds, Hh, Gs^Fds, Hh, Hh, Gs, Gs, Gs, Gs, Gs, Gs, Gs^Em, Gs^Fds, Hh, Gs^Fds, Hh, Hh, Mm, Mm, Mm, Mm, Mm, Mm, Mm, Mm, Mm
Mm, Hh, Gs^Fds, Gs^Fds, Gs^Fms, Hh, Gs^Fds, Gs, Re, Gs, Gs, Gs^Fds, Hh, Hh, Gs^Fds, Gs, Gs, Gs, Gs, Gs, Gs, Gs, Hh, Hh, Mm, Mm, Mm, Mm, Mm, Mm, Mm, Mm, Mm, Mm, Mm, Mm, Mm
Hh, Hh, Gs^Fms, Gs^Fds, Hh, Gs^Fms, Hh, Gs, Gs, Re, Gs, Gs, Gs^Fds, Gs^Fds, Gs^Vl, Gs, Gs, Gs, Gs, Gs^Fds, Hh, Gs^Fds, Mm, Mm, Mm, Mm, Mm, Mm, Mm, Mm, Mm, Mm, Mm, Mm, Mm, Mm, Mm
Hh, Hh, Gs^Fds, Hh, Gs^Fds, Gs^Fds, Gs^Fms, Gs, Gs, Re, Gs, Gs, Gs^Fds, Gs^Fds, Gs, Gs, Gs, Gs, Gs^Fds, Hh, Mm, Mm, Mm, Mm, Mm, Mm, Mm, Mm, Mm, Mm, Mm, Mm, Mm, Mm, Mm, Mm, Mm
Hh, Gs^Fds, Gs^Fds, Hh, Hh, Gs^Fds, Gs, Gs, Gs, Re, Gs, Gs, Gs^Fds, Gs, Gs, Gs, Gs, Gs^Fds, Hh, Hh, Mm, Mm, Mm, Mm, Mm, Mm, Mm, Mm, Mm, Mm, Mm, Mm, Mm, Mm, Mm, Mm, Hh
Hh, Hh, Gs^Fms, Hh, Gs^Fms, Gs^Efm, Gs, Gs, Gs, Re, Gs, Gs, Gs, Gs, Gs, Gs, Gs, Hh, Mm, Mm, Mm, Mm, Mm, Mm, Mm, Mm, Mm, Mm, Mm, Mm, Mm, Mm, Mm, Mm, Mm, Mm, Mm
Gs^Fds, Gs^Fds, Gs^Fds, Gs^Fms, Gs^Fds, Gs, Gs, Gs, Gs, Re, Gs^Es, Gs, Gs, Gs, Gs, Gs, Gs, Hh, Mm, Mm, Mm, Mm, Mm, Mm, Mm, Mm, Mm, Mm, Mm, Mm, Mm, Mm, Mm, Mm, Mm, Mm, Mm
Gs, Gs^Efm, Gs, Gs^Fds, Gs, Gs, Gs, Gs, Gs, Re, Re, Gs, Gs, Gs, Gs, Gs, Gs^Fds, Hh, Mm, Mm, Mm, Mm, Mm, Mm, Mm, Mm, Mm, Mm, Mm, Mm, Mm, Mm, Mm, Mm, Mm, Mm, Hh
Gg^Efm, Gs, Gg, Gs, Gg, Gs, Gs^Efm, Gs, Gg, Gs, Gs, Re, Re, Gs, Gs, Gs, Hh, Hh, Mm, Mm, Mm, Mm, Mm, Mm, Mm, Mm, Mm, Mm, Mm, Mm, Mm, Mm, Mm, Mm, Mm, Mm, Hh
Wwg, Gg, Gg, Gg, Gg, Gg, Gg, Gg, Gg, Gs, Gs, Gs, Re, Gs, Gs, Hh, Mm, Mm, Mm, Mm, Mm, Mm, Mm, Mm, Mm, Mm, Mm, Mm, Mm, Mm, Mm, Mm, Mm, Mm, Mm, Mm, Mm
Wwg, Wwg, Wwg, Wwg, Wwg, Wwg, Wwg, Wwg, Wwg, Gg, Gs, Gs, Re, Gs, Gs, Hh, Hh, Mm, Mm, Mm, Mm, Mm, Mm, Mm, Mm, Mm, Mm, Mm, Mm, Mm, Mm, Mm, Mm, Mm, Mm, Mm, Hh
Wwg, Wwg, Wwg, Wwg, Wwg, Wwg, Wwg, Wwg, Wwf, Gg, Gs^Vh, Gs, Re, Gs, Gs, Gs^Fds, Hh, 1 Hh, Gs^Fds, Mm, Kh, Ch, Rr^Vhc, 2 Mm, Mm, Mm, Mm, Mm, Mm, Mm, Mm, Mm, Mm, Mm, Mm, Mm, Mm
Gs^Fds, Gg, Gs^Fds, Wwg, Gs^Fds, Wwg, Gg, Wwf, Wwf, Wwf, Gg, Gg, Gg, Re, Gs, Gs^Fms, Gs^Fds, Gs^Fms, Rp, Ch, Ch, Ch, Rr, Rr^Vhc, Ch, Mm, Mm, Mm, Mm, Mm, Mm, Mm, Hh, Mm, Mm, Mm, Hh
Hh, Gs^Fds, Gs^Fds, Gg, Gg, Gg, Gg, Gg, Wwrg, Wwg, Wwg, Gg^Efm, Gg^Efm, Re, Re, Gs, Gs, Rp, Rp, Rr^Vhc, Rr, Rr, Rr, Ch, Kh, Mm, Mm, Mm, Mm, Mm, Mm, Hh, Gs^Fds, Hh, Hh, Hh, Hh
Hh, Hh, Gs^Fds, Gg, Gg, Gg, Hh, Hh, Hh, Wwg, Wwg, Gg, Gg, Gs^Fds, Gs^Fms, Re, Re, Rp, Rp, Rp, Rp, Rr, Rr, Ch, Ch, Mm, Mm, Mm, Mm, Mm, Mm, Hh, Gs^Fms, Gs^Fms, Gs^Fds, Gs^Fds, Hh
Hh, Gs^Fds, Gs^Fds, Gg, Gg, Gs^Fds, Hh, Hh, Mm, Wwrg, Wwg, Wwg, Rb^Gvs, Gs^Fds, Gs^Fms, Gs^Fds, Gs^Fds, Gs^Fds, Gs, Rp, Rp, Rp, Rp, Rr^Vhc, Rp, Hh, Mm, Mm, Mm, Mm, Hh, Hh, Gs^Fds, Gs^Fms, Gs^Fms, Hh, Gs^Fds
Hh, Gs^Fds, Gg, Gg, Gs^Fms, Gs^Fds, Hh, Mm, Mm, Gs^Fms, Wwg, Wwg, Rb^Gvs, Rb^Gvs, Gs^Vh, Gs^Fms, Gs, Gs, Gs, Re, Gs, Rp, Gs, Rp, Gs^Fms, Hh, Gs^Fms, Hh, Hh, Hh, Gs^Fds, Hh, Gs^Fds, Gs^Fms, Gs^Fds, Gs^Fms, Ww
Gs^Fds, Gs^Fms, Gs, Gs, Gs^Vh, Hh, Mm, Mm, Mm, Mm, Wwg, Wwg, Rb^Gvs, Rb^Gvs, Rb^Gvs, Rb^Gvs, Rb^Gvs, Rb, Gs^Es, Re, Gs, Gs, Gs^Vh, Gs^Fds, Rb^Gvs, Gs^Fms, Gs^Fms, Gs^Fms, Gs^Fms, Gs^Fms, Ww, Gs^Fds, Ww, Ww, Ww, Ww, Ww
Gs^Fms, Gs, Gs, Gs, Gs^Fds, Hh, Mm, Mm, Mm, Mm, Wwg, Wwg, Rb^Gvs, Rb^Gvs, Rb^Gvs, Rb^Gvs, Rb^Gvs, Rb^Gvs, Rb^Gvs, Re, Rb^Gvs, Rb^Gvs, Rb^Gvs, Rb^Gvs, Rb^Gvs, Rb^Gvs, Rb, Gs^Fms, Ww, Ww, Ww, Ww, Ww, Ww, Ww, Ww, Ww
Gs^Fms, Gs, Gs, Gs, Gs^Em, Hh, Hh, Mm, Mm, Mm, Wwrg, Wwg, Wwg, Rb^Gvs, Rb^Gvs, Rb^Gvs, Rb^Gvs, Rb^Gvs, Rb^Gvs, Re, Rb^Gvs, Rb^Gvs, Rb^Gvs, Rb^Gvs, Rb^Gvs, Rb^Gvs, Wwg, Ww, Ww, Ww, Gg, Ww, Gg, Ww, Gg, Ww, Gg
Gs^Fms, Gs, Gs, Gs, Gs, Gs^Fds, Gs^Fms, Hh, Hh, Hh, Hh, Wwg, Wwg, Wwg, Wwg, Wwg, Wwg, Rb^Gvs, Re, Re, Rb^Gvs, Rb^Gvs, Rb^Gvs, Rb^Gvs, Wwg, Wwg, Wwg, Ww, Gg, Gg, Gg^Efm, Gg, Gg, Gg, Gs, Gg, Gs
Gs, Gs, Gs, Gs, Gs, Gs, Gs^Fds, Gs^Fms, Gs^Fds, Hh, Gs^Fms, Gs^Fms, Gg, Wwg, Wwg, Wwg, Ww^Bsb/, Ww^Bsb/, Wwg, Wwg, Wwg, Wwg, Wwg, Wwg, Wwg, Wwg, Hh, Gg, Gg^Efm, Gs^Fms, Gs^Fds, Gs^Fms, Gs^Fds, Gs^Fds, Hh, Hh, Hh
Gs^Es, Gs, Gs, Gs, Gs, Gs, Gs^Fms, Gs^Fms, Gs^Fms, Gs^Fms, Gs^Fms, Gg, Gg, Gg, Re, Re, Rb^Gvs, Wwg, Wwg, Wwg, Wwg, Wwg, Wwg, Wwg, Hh, Hh, Hh, Gs^Fds, Gs^Fms, Gs^Fds, Gs^Fds, Gs^Fds, Gs^Fds, Gs^Fds, Hh, Hh, Hh
Gs^Fms, Gs^Fms, Gs, Gs, Gs, Gs, Gs, Gs^Fms, Gs^Fms, Gs^Fms, Gs, Gg, Gg, Gg, Re, Rb^Gvs, Rb^Gvs, Rb^Gvs, Rb^Gvs, Rb^Gvs, Re^Vwm, Gs^Fds, Gs^Fds, Gs^Fds, Hh, Hh, Hh, Hh, Hh, Hh, Hh, Gs^Fds, Hh, Gs^Fds, Gs^Fds, Hh, Gs^Fds
Hh^Em, Gs^Fds, Gs^Fms, Gs, Gs, Gs, Gs, Gs, Gs^Vh, Gs^Fms, Gs, Gs, Gs, Gg, Re, Rb^Gvs, Rb^Gvs, Rb^Gvs, Rb^Gvs, Rb^Gvs, Rb^Gvs, Rb^Gvs, Gs^Fds, Gs^Fds, Gs^Fds, Hh, Hh, Hh, Hh, Hh, Hh, Hh, Hh, Hh, Gs^Fds, Gs^Fds, Gs^Fds
Hh, Hh, Gs^Fms, Gs, Gs^Es, Gs, Gs, Gs, Gs, Gs^Fms, Gs, Gs, Gs, Gs, Re, Re, Re, Rb^Gvs, Rb^Gvs, Rb^Gvs, Rb^Gvs, Rb^Gvs, Gs^Fds, Gs^Fds, Gs^Fds, Gs^Fds, Hh, Hh, Hh, Gs^Fds, Gs^Fds, Gs^Fds, Hh, Hh, Hh, Hh, Hh
Hh, Hh, Gs^Fms, Gs, Gs, Gs, Gs, Gs, Gs, Gs, Gs, Gs, Re, Re, Gs, Gs, Gs, Re, Re, Rb^Gvs, Gs, Gs, Gs, Gs^Fds, Gs^Fds, Gs^Fds, Hh, Hh, Hh, Hh, Gs^Fds, Gs^Fds, Hh, Hh, Hh, Gs^Fds, Gs^Fds
Hh, Gs^Fds, Gs, Gs, Gs, Gs, Gs, Gs, Gs, Gs, Re, Re, Gs, Gs, Gs^Es, Gs^Fds, Gs^Fds, Gs, Gs, Re, Re, Gs, Rr, Gs^Fds, Rr, Gs^Fds, Gs^Fds, Gs^Fds, Gs^Fds, Hh, Hh, Gs^Fds, Gs^Fds, Hh, Hh, Hh, Hh
Gs^Fms, Gs^Fms, Gs, Gs, Gs, Gs, Ce, Gs, Re, Re, Gs, Gs, Gs, Gs, Gs^Fds, Gs^Fds, Gs^Fds, Gs, Gs^Es, Gs, Rr^Vhc, Rr, Rr, Rr^Vhc, Rr, Gs^Fds, Gs^Fds, Gs^Fds, Gs^Fds, Gs^Fds, Hh, Hh, Hh, Hh, Hh, Hh, Gs^Fds
Gs^Fms, Gs, Gs, Gs, Gs, Ce, 3 Ke, Re, Gs, Gs, Gs, Gs, Gs, Gs^Fds, Gs^Fds, Gs^Fds, Gs^Fds, Gs^Fds, Gs^Fds, Gs^Fds, Gg, Rr, Rr^Vhc, Rr, Ww, Gg^Efm, Gs^Fds, Gs^Fds, Hh, Gs^Fds, Gs^Fds, Hh, Hh, Hh, Hh, Hh, Gs^Fds
Gs, Gs, Gs^Vh, Gs, Re, Re, Ce, Ce, Gs, Gs, Gs, Gs, Gs, Gs, Gs^Fds, Gs^Fds, Gs^Fds, Gs^Fds, Gs^Fds, Gs^Fds, Gg^Efm, Ww, Ww, Ww, Ww, Ww, Gs^Fds, Gs^Fms, Gs^Fds, Hh, Hh, Gs^Fds, Hh, Hh, Gs^Fds, Gs^Fds, Gs^Fds
Gs, Gs, Re, Re, Gs, Gs, Gs, Gs, Gs, Gs, Gs^Es, Gs, Gs^Fds, Gs^Vh, Gs^Fds, Gs^Fds, Gs^Fds, Gs^Fds, Gs^Fds, Gs^Fds, Gg, Ww, Ww, Ww, Ww, Gg, Gs^Fds, Gs^Fds, Gs^Fms, Hh, Hh, Hh, Hh, Hh, Gs^Fds, Gs^Fds, Hh
Re, Re, Gs, Gs, Gs, Gs, Gs, Gs, Gs, Gs^Fds, Gs^Fds, Gs^Fds, Gs^Fds, Gs^Fds, Gs^Fds, Gs^Fds, Gs^Fds, Gs^Fds, Gs^Fds, Gs^Fds, Gs^Fds, Gg, Gs^Fds, Gg, Gs^Fds, Gs^Fds, Gs^Fds, Gs^Fds, Gs^Fds, Gs^Fds, Gs^Fds, Hh, Hh, Gs^Fds, Gs^Fds, Hh, Gs^Fds
