Hh, Gs, Hh, Gll^Fp, Gll^Fp, Gll^Fp, Hh, Hh, Gll^Fp, Gll^Fp, Gll^Fp, Gll^Fp, Gll^Fp, Gll^Fp, Gll^Fp, Gll^Fp, Gll^Fp, Gll^Fp, Gll^Fp, Gs, Gll^Fp, Gll^Fp, Gll^Fp, Gll^Fp, Gll^Fp, Hh, Hh, Hh, Hh, Hh, Mm, Ms
Gll^Fp, Hh, Gll^Fp, Hh, Hh, Gll^Fp, Gll^Fp, Gll^Fp, Gll^Fp, Gll^Fp, Gs, Gll^Fp, Gs, Gll^Fp, Gs, Gs, Gg, Gll^Fp, Gll^Fp, Gll^Fp, Gs^Em, Gll^Fp, Hh, Hh, Gll^Fp, Hh, Hh^Es, Hh, Hh, Hh, Mm, Mm
Gll^Fp, Gll^Fp, Gll^Fp, Hh^Es, Hh, Hh, Hh, Gll^Fp, Gs, Gs, Gs, Gs, Re, Re, Re, Re, Re, Gll^Fp, Rb^Gvs, Gll^Fp, Gll^Fp, Gll^Fp, Gll^Fp, Gll^Fp, Hh, Hh, Gll^Fp, Hh, Hh, Hh, Hh, Hh
Gs, Gll^Fp, Gll^Fp, Hh, Hh, Gll^Fp, Hh, Gll^Fp, Gs, Gs, Re, Re, Gs, Gs, Gg, Gd^Vo, Rb^Gvs, Re, Re, Rb^Gvs, Gd^Vo, Gll^Fp, Gll^Fp, Gll^Fp, Gll^Fp, Gll^Fp, Gll^Fp, Gs^Fp, Hh, Hh^Es, Hh, Hh
Gs, Gs, Gll^Fp, Gll^Fp, Hh, Gll^Fp, Gll^Fp, Gll^Fp, Re, Re, Re, Gs, Gg, Gs, Rb^Gvs, Rb^Gvs, Rb^Gvs, Ww, Ww, Re, Re, Rb^Gvs, Rb^Gvs, Gll^Fp, Gs, Gs, Gs, Gs^Fp, Gs^Fp, Hh, Gll^Fp, Gll^Fp
Gll^Fp, Gll^Fp, Gll^Fp, Gs, Gs^Em, Gll^Fp, Gs, Gs, Re, Re, Gs, Gs, Gs, Gs, Gg, Rb^Gvs, Rb^Gvs, Rb^Gvs, Rb^Gvs, Ww, Ww, Re, Rb^Gvs, Rb, Gs, Gs, Gs, Gs, Gs, Gll^Fp, Gll^Fp, Gll^Fp
Gll^Fp, Gs, Gll^Fp, Gll^Fp, Gs, Gs, Gs, Gs, Re, Gs, Gs, Gs, Gll^Fp, Gll^Fp, Gs, Gg, Rb^Gvs, Rb^Gvs, Rb^Gvs, Ww, Ww, Re, Re, Gg^Efm, Gs, Gs, Gs, Gs, Gs, Gs, Gs, Gll^Fp
Gs, Gll^Fp, Gs, Gs, Gs, Gs, Re, Re, Gs, Gs, Gs, Gs, Hh, Gll^Fp, Gs, Gs, Gg, Rb^Gvs, Rb^Gvs, Ww, Rb^Gvs, Gd^Vo, Re, Gs, Gs, Gs, Ce, Ce, Ce, Gs, Gs, Gs
Re, Re, Re, Re, Re, Re, Gs, Gs, Gs, Gs, Gll^Fp, Gs^Em, Hh, Gll^Fp, Gll^Fp, Gll^Fp, Gll^Fp, Gs, Gs, Rb^Gvs, Rb^Gvs, Re^Gvs, Gs, Re, Re, Re, Ce, 3 Ke, Ce, Gs, Gs, Gs
Gs, Gs, Gs, Gs, Gs, Re, Gs, Gs, Gll^Fp, Gs, Gs, Gll^Fp, Gll^Fp, Hh, Hh^Es, Hh, Gll^Fp, Gll^Fp, Gs, Gs, Gs, Gs, Re, Re, Gs, Gs, Gs, Ce, Re, Gs, Gs, Gs
Gs, Gs, Gd^Vo, Gs, Gs, Re, Re, Gs, Gs, Gs, Gll^Fp, Gll^Fp, Gll^Fp, Gll^Fp, Hh, Gll^Fp, Gs, Gll^Fp, Gs, Gs, Re, Re, Gs, Gs, Gs, Gs, Gs, Gs, Gs, Re, Re, Re
Gs, Gs, Gs, Gs, Gs, Gs, Gs, Re, Re, Gs, Gs, Gll^Fp, Gs, Gll^Fp, Gd^Vo, Gs, Gs, Gs, Re, Re, Gs, Gs, Gs, Gs, Gll^Fp, Gs, Gs^Fms, Gs, Gs, Gs, Gs, Gs
Gs, Gll^Fp, Gs, Gll^Fp, Gll^Fp, Gll^Fp, Gs, Gs, Gs, Gs, Gs, Gs, Gll^Fp, Gll^Fp, Gs, Gs, Gs, Gs, Re, Gs, Gs, Gs, Gs, Gs^Fms, Hh, Hh, Hh, Gll^Fp, Hh, Gs, Gs^Fms, Gs
Gs, Gll^Fp, Gll^Fp, Gs, Gll^Fp, Gll^Fp, Gll^Fp, Gs, Gs, Re, Gs, Gs, Gs, Gs, Gs, Gs, Re, Re, Gs, Gs, Gs, Gll^Fp, Gll^Fp, Hh, Gll^Fp, Gll^Fp, Gll^Fp, Hh, Gs^Fms, Gll^Fp, Hh, Gll^Fp
Gll^Fp, Gll^Fp, Gll^Fp, Gll^Fp, Gll^Fp, Gll^Fp, Gll^Fp, Gs, Gs, Re, Re, Gs, Gs, Gs, Re, Re, Gs, Gs, Gs, Gs, Gs, Gs, Gs^Fms, Hh, Gll^Fp, Rb^Es, Gd^Vo, Hh, Hh, Hh, Gs^Fms, Gll^Fp
Gll^Fp, Gs^Em, Gll^Fp, Gll^Fp, Gll^Fp, Gs, Gll^Fp, Gll^Fp, Gs, Gs, Gs, Re, Re, Re, Gs, Gs, Gs, Gs, Gs, Gs, Gll^Fp, Gll^Fp, Hh, Gs^Fms, Rb^Gvs, Rb^Gvs, Rb^Gvs, Rb^Gvs, Rb^Gvs, Gll^Gvs, Wwg, Gll^Fp
Gll^Fp, Gll^Fp, Gll^Fp, Gll^Fp, Gs, Gs, Gs, Gs, Gs, Gs, Gs, Gs, Gs, Re, Re, Gs, Gs, Gs, Gs, Gll^Fp, Hh^Es, Hh, Gg^Efm, Re^Gvs, Rb^Gvs, Rb^Gvs, Wwg, Rb^Gvs, Rb^Gvs, Rb^Gvs, Wwg, Wwg
Gll^Fp, Gll^Fp, Gll^Fp, Gd^Vo, Gs, Gs, Gs, Gs, Gs, Gll^Fp, Gs, Gs, Gs, Gs, Re, Gs, Gs, Gs, Gll^Fp, Gll^Fp, Gs^Fms, Gs, Ww, Ww, Ww, Wwg, Rb^Gvs, Wwg, Wwf, Wwg, Rb^Gvs, Rb^Gvs
Gll^Fp, Gll^Fp, Gll^Fp, Gll^Fp, Gll^Fp, Gll^Fp, Gs, Gll^Fp, Gll^Fp, Gs, Gs, Gs, Gs, Gs, Gs, Gs, Gs, Gs, Gll^Fp, Gll^Fp, Gd^Vo, Gg^Efm, Ww, Ww, Ww, Ww, Gs^Fms, Rb^Gvs, Rb^Gvs, Rb^Gvs, Gd^Vo, Rb^Gvs
Gll^Fp, Gll^Fp, Gll^Fp, Gll^Fp, Gs, Gll^Fp, Gll^Fp, Gll^Fp, Gll^Fp, Gs, Gs, Gs, Gs, Gs, Gs, Re, Re, Gs, Gs, Gs, Gg^Efm, Ww, Ww, Ww, Ww, Ww, Gs^Fms, Gll^Fp, Re, Rb^Gvs, Re, Rb
Gll^Fp, Gll^Fp, Gll^Fp, Hh^Es, Gll^Fp, Gs, Gll^Fp, Gll^Fp, Gs, Gs, Gll^Fp, Gs, Gs, Gs, Gs, Gs, Gs, Re, Re, Gs, Ww, Ww, Ww, Ww, Ww, Ww, Re, Re, Hh, Re, Hh^Es, Hh
Gll^Fp, Gll^Fp, Gll^Fp, Gll^Fp, Gs, Gs, Gll^Fp, Gll^Fp, Gs, Gs, Gs, Gs, Gs, Gs, Gll^Fp, Hh, Hh, Gs, Gs, Gg, Wwg, Ww, Ww, Ww, Gg^Efm, Ww, Re, Gs^Fms, Gll^Fp, Hh, Hh^Es, Hh
Gll^Fp, Gll^Fp, 2 Ke, Gll^Fp, Gll^Fp, Gs, Gs, Gll^Fp, Gll^Fp, Gll^Fp, Hh, Gll^Fp, Gll^Fp, Gs, Gll^Fp, Hh, Hh, Gll^Fp, Gg^Efm, Re, Wwf, Gg^Efm, Gs, Gg, Re, Gd^Vo, Gll^Fp, Gll^Fp, Hh, Hh, Hh, Hh
Gll^Fp, Ce, Ce, Ce, Gll^Fp, Gll^Fp, Hh, Hh, Hh, Gll^Fp, Gll^Fp, Hh, Hh, Gs^Em, Gs, Hh, Hh, Gs, Wwg, Wwg, Gg, Re, Gs^Fms, Re, Gs^Fms, Gs^Fms, Gll^Fp, Hh^Es, Hh, Hh, Mm, Mm
Gll^Fp, Gll^Fp, Gll^Fp, Gll^Fp, 1 Ke, Ce, Gs^Fms, Gll^Fp, Gll^Fp, Gll^Fp, Hh, Hh, Hh, Gs, Gd^Vo, Gs^Es, Hh, Hh, Wwg, Wwg, Gs, Gll^Fp, Hh, Hh, Hh, Gll^Fp, Gll^Fp, Gll^Fp, Hh, Gs^Fp, Mm, Mm
Gll^Fp, Gll^Fp, Gll^Fp, Ce, Ce, Hh, Mm, Hh, Hh, Hh, Mm, Mm, Mm, Hh, Hh, Hh^Es, Wwg, Wwg, Hh^Es, Hh, Hh, Hh, Hh, Hh, Chr, Hh, Hh, Gs^Fp, Hh, Mm, Mm, Mm
Gll^Fp, Gll^Fp, Gll^Fp, Gll^Fp, Hh, Hh, Mm, Mm, Mm, Mm, Mm, Mm, Mm, Mm, Mm, Hh, Wwg, Hh, Hh, Hh, Hh, Hh^Es, Mm, Chr, Khr, Chr, Chr, Hh, Hh, Hh, Mm, Mm
Gll^Fp, Gll^Fp, Hh, Hh, Hh, Mm, Mm, Mm, Mm, Mm, Mm, Mm, Mm, Mm, Mm, Mm, Wwg, Mm, Mm, Mm, Mm, Mm, Mm, Chr, Chr, Chr, Mm, Mm, Mm, Mm, Mm, Mm
