Hh, Gs, Hh, Gs^Fp, Gs^Fp, Gs^Fp, Hh, Hh, Gs^Fp, Gs^Fp, Gs^Fp, Gs^Fp, Gs^Fp, Gs^Fp, Gs^Fp, Gs^Fp, Gs^Fp, Gs^Fp, Gs^Fp, Gs, Gs^Fp, Gs^Fp, Gs^Fp, Gll^Fp, Gll^Fp, Hh, Hh, Hh, Hh, Hh, Mm, Ms
Gs^Fp, Hh^Fp, Gs^Fp, Hh, Hh^Fp, Gs^Fp, Gs^Fp, Gs^Fp, Gs^Fp, Gs^Fp, Gs, Gs^Fp, Gs, Gs^Fp, Gs^Efm, Gs, Gg, Gs^Fp, Gs^Fp, Gs^Fp, Gs^Em, Gs^Fp, Hh, Hh, Gs^Fp, Hh, Hh^Fp, Hh, Hh, Hh, Mm, Mm
Gs^Fp, Gs^Fp, Gs^Fp, Hh^Es, Hh, Hh^Fp, Hh, Gs^Fp, Gs^Fp, Gs^Fp, Gs, Gs, Re, Re, Re, Re, Re, Gs^Fp, Rb^Gvs, Gs^Fp, Gs^Fp, Gs^Fp, Gs^Fp, Gs^Fp, Hh, Hh, Gs^Fp, Hh^Fp, Hh, Hh^Es, Hh, Hh
Gs, Gs^Fp, Gs^Fp, Hh, Hh, Gs^Fp, Hh, Gs^Fp, Gs, Gs, Re, Re, Gs, Gs, Gg, Gs^Vo, Rb^Gvs, Re, Re, Rb^Gvs, Gs^Vo, Gs^Fp, Gs^Fp, Gs^Fp, Gs^Fp, Gs^Fp, Gll^Fp, Gs^Fp, Hh^Fp, Hh^Fp, Hh, Hh
Gs, Gs, Gs^Fp, Gs^Fp, Hh^Fp, Gs^Fp, Gs^Fp, Gs^Fp, Re, Re, Re, Gs^Efm, Gg, Gs, Rb^Gvs, Rb^Gvs, Rb^Gvs, Ww, Ww, Re, Re, Rb^Gvs, Rb^Gvs, Gs^Fp, Gs^Fp, Gs^Fp, Gs^Fp, Gs^Fp, Gs^Fp, Hh^Fp, Gs^Fp, Gs^Fp
Gs^Fp, Gs^Fp, Gs^Fp, Gs^Efm, Gs^Em, Gs^Fp, Gs, Gs, Re, Re, Gs, Gs, Gs, Gs, Gg, Rb^Gvs, Rb^Gvs, Rb^Gvs, Rb^Gvs, Ww, Ww, Re, Rb^Gvs, Rb, Gs, Gs, Gs, Gs^Es, Gs^Fp, Gs^Fp, Gs^Fp, Gs^Fp
Gs^Fp, Gs, Gs^Fp, Gs^Fp, Gs^Fp, Gs, Gs, Gs, Re, Gs, Gs, Gs, Gs^Fp, Gs^Fp, Gs, Gg, Rb^Gvs, Rb^Gvs, Rb^Gvs, Ww, Ww, Re, Re, Gg^Efm, Gs, Gs, Gs, Gs, Gs, Gs, Gs^Fp, Gs^Fp
Gs, Gs^Fp, Gs, Gs^Fp, Gs, Gs, Re, Re, Gs, Gs, Gs, Gs, Hh^Fp, Gs^Fp, Gs, Gs, Gg, Rb^Gvs, Rb^Gvs, Ww, Rb^Gvs, Gs^Vo, Re, Gs, Gs, Gs, Ce, Ce, Ce, Gs, Gs, Gs
Re, Re, Re, Re, Re, Re, Gs, Gs, Gs, Gs, Gs^Fp, Gs^Em, Hh, Gs^Fp, Gs^Fp, Gs^Fp, Gs^Fp, Gs, Gs, Rb^Gvs, Rb^Gvs, Re^Gvs, Gs, Re, Re, Re, Ce, 3 Ke, Ce, Gs, Gs, Gs
Gs, Gs, Gs, Gs, Gs, Re, Gs, Gs, Gs^Fp, Gs, Gs, Gs^Fp, Gs^Fp, Hh^Fp, Hh^Es, Hh, Gs^Fp, Gs^Fp, Gs, Gs, Gs, Gs, Re, Re, Gs, Gs, Gs, Ce, Re, Gs, Gs, Gs
Gs^Fp, Gs, Gs^Vo, Gs, Gs, Re, Re, Gs, Gs, Gs, Gs^Fp, Gs^Fp, Gs^Fp, Gs^Fp, Hh, Gs^Fp, Gs, Gs^Fp, Gs, Gs, Re, Re, Gs, Gs, Gs, Gs, Gs, Gs, Gs, Re, Re, Re
Gs^Fp, Gs, Gs, Gs, Gs^Fp, Gs, Gs, Re, Re, Gs, Gs, Gs^Fp, Gs^Fp, Gs^Fp, Gs^Vo, Gs^Fp, Gs, Gs, Re, Re, Gs, Gs, Gs, Gs, Gs^Fp, Gs, Gs^Fms, Gs, Gs, Gs, Gs, Gs
Gs, Gs^Fp, Gs, Gs^Fp, Gs^Fp, Gs^Fp, Gs, Gs, Gs, Gs, Gs, Gs, Gs^Fp, Gs^Fp, Gs, Gs, Gs, Gs, Re, Gs, Gs, Gs, Gs^Efm, Gs^Fms, Hh^Fp, Hh, Hh, Gs^Fp, Hh^Fp, Gs^Fp, Gs^Fms, Gs
Gs, Gs^Fp, Gs^Fp, Gs, Gs^Fp, Gs^Fp, Gs^Fp, Gs, Gs, Re, Gs, Gs, Gs, Gs, Gs, Gs, Re, Re, Gs, Gs, Gs, Gs^Fp, Gs^Fp, Hh, Gs^Fp, Gs^Fp, Gs^Fp, Hh, Gs^Fms, Gs^Fp, Hh, Gs^Fp
Gs^Fp, Gs^Fp, Gs^Fp, Gs^Fp, Gs^Fp, Gs^Fp, Gs^Fp, Gs, Gs, Re, Re, Gs, Gs^Es, Gs, Re, Re, Gs, Gs, Gs^Efm, Gs, Gs, Gs, Gs^Fms, Hh, Gs^Fp, Rb^Es, Re^Vo, Hh, Hh, Hh, Gs^Fms, Gs^Fp
Gs^Fp, Gs^Em, Gs^Fp, Gs^Fp, Gs^Fp, Gs, Gs^Fp, Gs^Fp, Gs, Gs, Gs, Re, Re, Re, Gs, Gs, Gs, Gs^Efm, Gs, Gs, Gs^Fp, Gs^Fp, Hh^Fp, Gs^Fms, Rb^Gvs, Rb^Gvs, Rb^Gvs, Rb^Gvs, Rb^Gvs, Gll^Gvs, Wwg, Gs^Fp
Gs^Fp, Gs^Fp, Gs^Fp, Gs^Fp, Gs, Gs, Gs, Gs, Gs, Gs, Gs, Gs, Gs, Re, Re, Gs, Gs, Gs, Gs, Gs^Fp, Hh^Es, Hh, Gg^Efm, Re^Gvs, Rb^Gvs, Rb^Gvs, Wwg, Rb^Gvs, Rb^Gvs, Rb^Gvs, Wwg, Wwg
Gs^Fp, Gs^Fp, Gs^Fp, Gs^Vo, Gs, Gs, Gs, Gs, Gs, Gs^Fp, Gs, Gs, Gs, Gs, Re, Gs, Gs, Gs, Gs^Fp, Gs^Fp, Gs^Fms, Gs, Ww, Ww, Ww, Wwg, Rb^Gvs, Wwg, Wwf, Wwg, Rb^Gvs, Rb^Gvs
Gs^Fp, Gs^Fp, Gs^Fp, Gs^Fp, Gs^Fp, Gs^Fp, Gs, Gs^Fp, Gs^Fp, Gs, Gs^Fp, Gs, Gs, Gs, Gs^Es, Gs, Gs, Gs, Gs^Fp, Gs^Fp, Gs^Vo, Gg^Efm, Ww, Ww, Ww, Ww, Gs^Fms, Rb^Gvs, Rb^Gvs, Rb^Gvs, Re^Vo, Rb^Gvs
Gs^Fp, Gs^Fp, Gs^Fp, Gs^Fp, Gs, Gs^Fp, Gs^Fp, Gs^Fp, Gs^Fp, Gs^Fp, Gs^Fp, Gs^Fp, Gs, Gs, Gs, Re, Re, Gs, Gs, Gs, Gg^Efm, Ww, Ww, Ww, Ww, Ww, Gs^Fms, Gs^Fp, Re, Rb^Gvs, Re, Rb
Gs^Fp, Gs^Fp, Gs^Fp, Hh^Es, Gs^Fp, Gs, Gs^Fp, Gs^Fp, Gs, Gs, Gs^Fp, Gs^Fp, Gs^Fp, Gs, Gs^Fp, Gs, Gs, Re, Re, Gs, Ww, Ww, Ww, Ww, Ww, Ww, Re, Re, Hh, Re, Hh^Fp, Hh
Gs^Fp, Gs^Fp, Gs^Fp, Gs^Fp, Gs, Gs, Gs^Fp, Gs^Fp, Gs, Gs, Gs, Gs^Fp, Gs^Fp, Gs, Gs^Fp, Hh, Hh, Gs, Gs, Gg, Wwg, Ww, Ww, Ww, Gg^Efm, Ww, Re, Gs^Fms, Gs^Fp, Hh, Hh^Es, Hh
Gs^Fp, Gs^Fp, 2 Ke, Gs^Fp, Gs^Fp, Gs, Gs, Gs^Fp, Gs^Fp, Gs^Fp, Hh^Fp, Gs^Fp, Gs^Fp, Gs, Gs^Fp, Hh^Fp, Hh, Gs^Fp, Gg^Efm, Re, Wwf, Gg^Efm, Gs, Gg, Re, Re^Vo, Gs^Fp, Gs^Fp, Hh^Fp, Hh, Hh, Hh
Gs^Fp, Ce, Ce, Ce, Gs^Fp, Gs^Fp, Hh, Hh^Fp, Hh, Gs^Fp, Gs^Fp, Hh, Hh, Gs^Em, Gs, Hh, Hh^Fp, Gs, Wwg, Wwg, Gg, Re, Gs^Fms, Re, Gs^Fms, Gs^Fms, Gs^Fp, Hh^Fp, Hh^Fp, Hh, Mm, Mm
Gs^Fp, Gs^Fp, Gs^Fp, Gs^Fp, 1 Ke, Ce, Gs^Fms, Gs^Fp, Gs^Fp, Gs^Fp, Hh, Hh, Hh, Gs, Gs^Vo, Gs^Es, Hh, Hh, Wwg, Wwg, Gs^Efm, Gs^Fp, Hh^Fp, Hh^Fp, Hh, Gs^Fp, Gs^Fp, Gs^Fp, Hh, Gs^Fp, Mm, Mm
Gs^Fp, Gs^Fp, Gs^Fp, Ce, Ce, Hh^Fp, Mm, Hh, Hh, Hh, Mm, Mm, Mm, Hh, Hh, Hh^Es, Wwg, Wwg, Hh^Es, Hh, Hh^Fp, Hh, Hh, Hh, Chr, Hh, Hh, Gs^Fp, Hh, Mm, Mm, Mm
Gs^Fp, Gs^Fp, Gs^Fp, Gs^Fp, Hh^Fp, Hh, Mm, Mm, Mm, Mm, Mm, Mm, Mm, Mm, Mm, Hh, Wwg, Hh, Hh, Hh, Hh, Hh^Es, Mm, Chr, Khr, Chr, Chr, Hh, Hh, Hh, Mm, Mm
Gs^Fp, Gs^Fp, Hh, Hh^Fp, Hh, Mm, Mm, Mm, Mm, Mm, Mm, Mm, Mm, Mm, Mm, Mm, Wwg, Mm, Mm, Mm, Mm, Mm, Mm, Chr, Chr, Chr, Mm, Mm, Mm, Mm, Mm, Mm
