Gs^Fp, Hh, Hh, Hh, Gs^Fp, Gs^Fp, Gs^Fp, Gs^Fp, Gs^Fp, Gs^Fp, Gs^Fp, Gs, Gs, Re, Gs, Gs, Gs, Re, Gs, Gs^Fp, Gs^Fp, Gs, Gs^Fp, Gs^Fp, Gs^Fp, Gs^Fp, Gs^Fp, Hh, Hh, Mm, Hh, Hh, Mm, Mm, Mm, Mm, Mm, Mm, Mm, Mm
Gs^Fp, Hh^Fp, Hh, Hh^Fp, Hh, Hh, Hh, Hh^Fp, Hh, Gs^Fp, Gs^Efm, Gs, Gs, Re, Gs, Gs, Re, Re^Vo, Gs^Fp, Gs^Fp, Gs^Fp, Gs^Fp, Rb^Gvs, Gs^Fp, Re^Vo, Gs^Fp, Re, Gs^Fp, Re, Hh, Chr, Chr, Mm, Mm, Mm, Mm, Mm, Mm, Mm, Mm
Gs^Fp, Hh, Gs^Fp, Hh, Hh^Fp, Hh, Gs^Fp, Hh^Fp, Hh^Fp, Gs^Fp, Gs^Fp, Gs, Gs, Re, Gs, Gs, Gs^Fp, Gs^Efm, Gs^Fp, Gs^Fp, Re, Rb^Gvs, Re, Re, Re, Re, Gs^Fp, Re, Gs^Fp, Re, Chr, Khr, Mm, Mm, Mm, Mm, Mm, Mm, Mm, Mm
Gs^Fp, Gs^Fp, Hh, Hh, Hh^Fp, Hh^Fp, Gs^Fp, Gs^Fp, Hh, Hh^Fp, Gs, Gs, Gs, Re, Gs, Gg, Gs^Fp, Gs^Fp, Gs^Fp, Re, Rb^Gvs, Re, Rb^Gvs, Rb^Gvs, Gg^Fp, Gd, Gs^Fp, Hh, Hh, Hh, Hh, Chr, Chr, Mm, Mm, Mm, Mm, Mm, Mm, Gd
Gs^Fp, Gs^Fp, Hh, Gs^Fp, Gs^Fp, Re^Vo, Re, Gs^Fp, Gs^Fp, Gs^Efm, Gs, Gs, Gs, Re, Gs, Gs, Gs^Efm, Gs^Fp, Re, Re, Rb^Gvs, Rb^Gvs, Rb^Gvs, Rb^Gvs, Gg^Efm, Gs^Fp, Gs^Fp, Gs^Fp, Gs^Fp, Gs^Fp, Hh, Mm, Mm, Mm, Mm, Mm, Mm, Mm, Mm, Mm
Gs^Fp, Gs^Fp, Hh, Hh, Hh, Gs^Fp, Re, Gs^Fp, Gs, Gs, Gs, Gs, Re, Re, Re, Gs, Re, Re, Re^Vo, Rb^Gvs, Rb^Gvs, Rb^Gvs, Wwg, Wwg, Wwg, Hh, Gg^Fp, Gg^Fp, Gg^Fp, Hh^Fp, Hh, Mm, Mm, Mm, Mm, Mm, Mm, Mm, Mm, Mm
Hh, Hh, Hh^Fp, Gs^Fp, Gs^Fp, Gs^Fp, Gs^Fp, Re, Gs, Gs, Re, Re, Gs, Gs, Re, Re, Rb^Gvs, Re^Efm, Rb^Gvs, Rb^Gvs, Rb^Gvs, Wwg^Ewl, Wwg, Wwg, Wwg, Hh, Wwg^Ewl, Gg^Efm, Wwg, Hh^Fp, Mm, Mm, Mm, Mm, Mm, Mm^Vhh, Hh, Mm, Hh, Hh
Gs^Fp, Hh, Gs^Fp, Hh^Fp, Hh^Fp, Gs^Fp, Gs^Fp, Gs, Re, Re, Gs, Gs, Gs, Gs, Re, Rb^Gvs, Rb^Gvs, Rb^Gvs, Rb^Gvs, Rb^Gvs, Wwg, Wwg, Wwg, Wwg, Wwg, Wwg^Ewf, Wwg, Wwg, Wwg^Ewl, Hh, Mm, Mm, Mm, Mm, Hh, Hh, 3 Ke, Hh, Ce, Hh
Gs^Fp, Gs^Fp, Hh^Fp, Hh^Fp, Hh, Gs^Fp, Gs, Gs, Re, Gs, Gs, Gs, Gs^Fp, Gs, Gs, Re, Rb^Gvs, Rb^Gvs, Rb^Gvs, Rb^Gvs, Wwg, Wwg, Wwg, Wwg, Wwg, Wwg, Wwg, Wwg, Hh, Hh, Mm, Mm, Mm, Mm, Hh, Ce, Ce, Ce, Gs, Re
Gs^Fp, Hh, Hh, Gs^Fp, Gs^Fp, Gs^Efm, Gs, Re, Gs, Gs, Gs, Gs^Fp, Gs, Gs, Gs, Re, Re, Rb^Gvs, Rb^Gvs, Rb^Gvs, Wwg, Wwg, Wwg, Wwg, Hh, Wwg^Ewl, Hh, Mm, Mm, Mm, Mm, Mm, Mm, Mm, Hh, Ce, Ce, Gs, Hh, Hh
Gs^Fp, Gs^Fp, Gs, Gs^Fp, Gs, Gs, Gs, Re, Gs, Gs, Gs^Fp, Gs^Fp, Re^Vo, Re, Hh^Fp, Gs, Re, Rb^Gvs, Rb^Gvs, Rb^Gvs, Wwg, Wwg, Hh^Efm, Hh^Efm, Hh, Hh, Mm, Hh, Mm, Mm, Mm, Mm, Mm, Mm, Gs, Re, Gs, Gs, Hh^Vhh, Mm
Hh, Re^Vo, Re, Gs, Gs, Gs, Re, Re, Gs, Gs, Gs^Fp, Gs^Fp, Gs^Fp, Gs^Fp, Hh, Hh^Fp, Gs^Fp, Re, Re, Gg, Wwg, Wwg, Hh, Hh, Mm, Mm, Mm, Mm, Mm, Mm, Mm, Mm, Mm, Mm, Hh, Re, Hh, Hh, Mm, Mm
Gll^Fp, Hh, Gs^Fp, Gs, Gs, Gs, Re, Gs, Gs, Gs, Gs^Fp, Gs^Fp, Gs^Fp, Hh, Mm, Hh, Hh, Gs^Fp, Re, Re^Vo, Wwg, Wwg, Gg^Efm, Hh, Hh^Fp, Mm, Mm, Mm, Mm, Mm, Mm, Hh, Gs^Fp, Hh, Re, Re, Hh, Mm, Mm, Mm
Co, Co, Co, Gs^Fp, Gs^Fp, Gs, Re, Gs, Gs^Fp, Gs^Fp, Gs^Fp, Gs^Fp, Hh, Hh, Mm, Hh^Fp, Hh^Efm, Gs^Fp, Wwg, Wwf^Bsb\, Wwg^Bsb\, Wwf, Gg, Hh^Fp, Hh^Fp, Mm, Hh, Mm, Mm, Hh, Hh^Fp, Gs^Fp, Re^Vo, Gs, Re, Hh, Gs^Fp, Hh, Mm, Mm
Co, 2 Ko, Co, Hh^Fp, Gs^Fp, Gs, Re, Gs, Gs^Fp, Gs^Fp, Hh^Fp, Hh, Mm, Mm, Wwg^Ewl, Wwrg, Ww, Wwg, Wwg, Wwg, Gg^Efm, Rb, Gg^Efm, Gg, Gg^Fp, Hh^Fp, Hh^Fp, Hh^Efm, Hh^Fp, Hh^Fp, Gs^Fp, Gs^Fp, Gs, Re, Gs, Gs, Gs, Gs^Fp, Gs^Fp, Ms
Co, 1 Ko, Co, Hh, Gs, Gs, Re, Gs, Gs^Fp, Gs^Fp, Hh, Mm, Mm, Mm, Wwrg, Ww, Ww, Ww, Wwrg, Gg^Efm, Re, Re, Gs, Gg, Gg^Fp, Gs^Fp, Gs, Hh, Gs, Gs^Fp, Gs, Gs, Re, Re, Gs, Gs, Gs, Gs^Fp, Gs^Fp, Gs^Fp
Hh, Co, Hh, Re, Re, Re, Gs, Gs, Gs^Vo, Hh, Mm, Mm, Wwrg, Hh, Ww, Ww, Ww, Ww, Gg^Efm, Gg^Efm, Re, Gs^Edt, Ce, Gs, Gs, Gs, Re^Vo, Gs, Gs, Gs, Re, Gs, Gs, Gs, Gs, Gs, Gs, Gs, Gs, Gs^Fp
Hh, Hh, Gs^Fp, Gs, Gs, Re, Gs, Gs, Gs^Fp, Hh^Fp, Hh, Hh, Wwrg, Ww, Ww, Ww, Wwg, Wwg^Ewl, Gg^Fp, Re, Ce, Ce, 4 Ke, Ce, Ce, Gs, Re, Gs, Re, Re, Gs, Re, Re, Re, Re, Re, Re, Gs, Re, Gs
Gs^Fp, Gs^Fp, Gs^Fp, Gs^Fp, Gs, Re, Gs, Gs^Fp, Gs^Fp, Hh, Mm, Hh^Fp, Gg^Fp, Wwg^Ewf, Wwg, Ww, Wwf, Gg^Fp, Gs, Re, Re^Edt, Re^Dr, Re^Edt, Ce, Re, Re, Re, Re, Gs, Gs, Gs, Gs, Gs, Gs, Gs, Gs, Gs, Re, Gs, Re
Gs^Fp, Gs^Fp, Re, Gs, Re, Re, Gs, Gs, Gs^Fp, Hh^Fp, Hh, Hh^Fp, Gg^Fp, Gg^Fp, Wwg, Ww, Gg^Fp, Gg^Fp, Gd, Ce, Re^Edt, Re, Re, Re, Gs, Gs, Gs, Gs, Gs, Gs^Fp, Hh^Fp, Gs^Fp, Hh^Fp, Gs^Fp, Gs^Fp, Gs, Gs^Fp, Gs, Gs, Gs
Re, Re, Re^Vo, Re, Re, Gs, Gs, Gs, Gs, Gll^Fp, Hh, Hh^Fp, Gs^Fp, Gg^Fp, Wwg, Wwg, Gg^Fp, Gg^Fp, Gs^Edt, Ce, 5 Ke, Re, Gs, Gs, Gs, Gs, Gs^Fp, Gs, Gs^Fp, Gs^Fp, Gs^Fp, Hh^Fp, Hh, Hh, Hh, Gs^Vo, Gs^Fp, Gs^Fp, Gs, Gs
Gs^Fp, Gs, Gs, Gs, Gs, Re, Re, Gs, Gs, Gs, Hh^Fp, Gs^Fp, Rb^Gvs, Gg^Fp, Wwg, Wwg, Wwg, Gg, Gs, Ce, Ce, Re, Re^Edt, Gs, Gs, Gs, Gd^Fp, Gs, Gs, Gs, Gs^Fp, Hh, Gs^Fp, Gs^Fp, Gs^Fp, Hh^Fp, Hh, Gs^Fp, Gs^Fp, Gs^Fp
Gs^Fp, Gs^Fp, Gs, Gs^Fp, Gs, Gs, Gs, Re, Re, Gs, Gg, Gs^Vo, Rb^Gvs, Rb^Gvs, Rb^Gvs, Wwg, Wwf, Rb^Gvs, Gg^Efm, Gd, Ce, Ce, Gs, Re, Gs, Gs^Fp, Gs, Gg^Fp, Gs^Fp, Gs^Fp, Gs^Fp, Hh, Gs^Fp, Gs^Fp, Hh, Hh, Mm, Hh, Gs^Fp, Gs^Fp
Gs^Fp, Gs^Fp, Re, Gs, Gs^Fp, Gs^Fp, Gs^Fp, Gs, Gs, Re, Re, Rb^Gvs, Rb^Gvs, Rb^Gvs, Rb^Gvs, Wwf, Wwf, Rb^Gvs, Rb^Gvs, Gs, Gs, Gs, Gs, Re, Gs, Gs^Fp, Gs^Fp, Gs^Fp, Gs, Gs^Fp, Gs^Fp, Gs^Fp, Gs^Fp, Gs^Fp, Hh, Mm, Mm, Hh, Hh, Gs^Fp
Gs^Fp, Gs^Fp, Gs, Gs^Fmw, Gs, Hh^Fp, Hh^Fp, Gs, Gs^Fp, Gs, Rb^Gvs, Re, Re, Rb^Gvs, Wwg, Wwg, Rb^Gvs, Rb^Gvs, Rb^Gvs, Rb^Gvs, Rb^Gvs, Gs, Re, Re, Gs, Gs, Hh, Gs^Fp, Gs^Fp, Gs^Fp, Gs, Gs^Fp, Gs, Hh^Fp, Hh, Mm, Mm, Mm, Mm, Hh
Hh, Gs^Fp, Re, Gs^Fmw, Gs^Fmw, Gs^Fmw, Hh^Fp, Hh^Fp, Gs, Rb^Gvs, Rb^Gvs, Rb^Gvs, Rb^Gvs, Wwf^Bsb\, Wwg^Bsb\, Wwg, Rb^Gvs, Rb^Gvs, Re, Rb^Gvs, Re, Re, Rb^Gvs, Rb^Gvs, Rb^Gvs, Gs, Hh^Fp, Hh^Fp, Gs^Fp, Gs, Re^Vo, Hh^Fp, Hh^Fp, Hh, Hh, Mm, Mm, Mm, Mm, Mm
Gll^Fp, Gs, Re, Gs^Fmw, Re^Vo, Gs^Fp, Hh^Fp, Hh^Fp, Gs^Fp, Rb^Gvs, Rb^Gvs, Rb^Gvs, Rb^Gvs, Wwg, Wwg, Re^Bsb\, Re, Re, Re^Vo, Re, Rb^Gvs, Rb^Gvs, Rb^Gvs, Rb^Gvs, Rb^Gvs, Gs, Gs, Hh^Efm, Re, Re, Hh, Hh, Hh, Hh, Hh, Mm, Mm, Mm, Mm, Mm
Hh, Hh, Gs, Re, Gs, Gs^Fp, Hh^Fmw, Hh^Fp, Gs^Fp, Gs, Gg^Fp, Rb^Gvs, Gg^Fp, Wwg, Wwg, Rb^Gvs, Rb^Gvs, Rb^Gvs, Rb^Gvs, Rb^Gvs, Rb^Gvs, Rb^Gvs, Gs^Fp, Gs^Fp, Gs^Fp, Gs, Gs^Fp, Gs, Gs^Fp, Hh, Hh, Mm, Mm, Mm, Mm, Mm, Mm, Mm, Mm, Mm
Gs^Fp, Gs^Fp, Gs^Fp, Gs^Fp, Gs^Fp, Hh^Fmw, Hh^Fmw, Hh^Fmw, Hh^Fp, Gs^Fp, Hh^Fp, Gg^Fp, Gg^Fp, Wwg, Wwg, Gg^Fp, Gg^Fp, Gg^Fp, Gs^Fp, Gs^Fp, Gs^Fp, Gs^Fp, Gs^Fp, Gs^Fp, Gs^Fp, Gs^Fp, Gs, Gs^Fp, Hh, Hh, Mm, Mm, Mm, Mm, Gll^Fp, Mm, Mm, Mm, Mm, Mm
