Gll^Fp, Gll^Fp, Gll^Fp, Gll^Fp, Gll^Fp, Gg, Gll^Fp, Gll^Fp, Hh, Hh, Hh, Hh, Gll^Fp, Gll^Fp, Gg, Wwg, Wwg, Wwg, Gg, Hh, Hh, Gs, Gll^Fp, Gs, Gll^Fp, Gs, Gll^Fp, Hh, Gll^Fp, Gll^Fp, Gs, Gs, Gs, Re, Gs, Gs, Gs, Gs, Gs, Gs, Hh, Hh, Hh, Hh
Gll^Fp, Gll^Fp, Gll^Fp, Gll^Fp, Gll^Fp, Gll^Fp, Gll^Fp, Gll^Fp, Hh, Hh, Gll^Fp, Gll^Fp, Gll^Fp, Hh, Gll^Fp, Gg, Wwg, Wwg, Gg, Gll^Fp, Hh, Hh, Gll^Fp, Gll^Fp, Gll^Fp, Gll^Fp, Hh, Hh, Gll^Fp, Gll^Fp, Gs, Gs, Gs, Re, Gs, Gs, Gd^Vo, Gs, Gll, Gs, Hh, Hh, Hh, Hh
Hh, Hh, Gll^Fp, Gll^Fp, Hh, Hh, Hh, Hh, Hh, Hh, Gll^Fp, Gll^Fp, Hh, Gll^Fp, Gg, Gg, Wwg, Wwg, Gg, Gll^Fp, Gll^Fp, Hh, Hh, Gll^Fp, Gll^Fp, Gll^Fp, Gll^Fp, Hh, Co, Gll^Fp, Gll, Gs, Gs, Re, Gs, Gs, Gs, Gs, Gll, Gll^Fp, Hh, Hh, Hh, Hh
Hh, Hh, Hh, Hh, Hh, Hh, Gll^Fp, Gll^Fp, Gll^Fp, Gll, Gs, Hh, Gs, Gll^Fp, Gg, Gg, Wwf, Wwf, Gg, Gll, Gll, Gd^Vo, Hh, Hh, Gll^Fp, Gll^Fp, Hh, 3 Ko, Co, Co, Rb, Gs, Gs, Re, Gs, Gs, Gs, Gll, Hh, Hh, Hh, Hh, Hh, Hh
Gll^Fp, Hh, Gs, Gd^Vo, Gs, Gll, Gll, Gll^Fp, Gll^Fp, Gll, Gs, Gs, Gll^Fp, Gg, Gll^Fp, Wwf, Wwg, Wwf, Gg, Gll, Gll^Fp, Gs, Hh, Gll^Fp, Gll^Fp, Hh, Hh, Co, Co, Rb, Gs, Gs, Gs, Re, Gs, Gs, Gs, Gll^Fp, Hh, Hh, Gll^Fp, Gll^Fp, Gll^Fp, Hh
Gll^Fp, Gll^Fp, Gll, Gs, Gs, Gs, Gs, Gs, Gs, Gg, Gd^Vo, Gll^Fp, Gll^Fp, Gll^Fp, Wwg, Wwg, Wwg, Wwg, Gg, Gll^Fp, Gll^Fp, Hh, Gll^Fp, Hh, Hh, Gll^Fp, Gll, Hh, Rb, Rb, Gs, Gs, Re, Re, Gs, Gs, Gs, Gll^Fp, Hh, Hh, Gll, Gll^Fp, Gll^Fp, Hh
Gg, Gll^Fp, Gg, Gg, Wwf, Gg, Wwf, Gs, Gg, Gs, Gg, Gll^Fp, Wwg, Wwg, Wwg, Wwg, Wwf, Wwg, Wwg, Gg, Gg, Gll^Fp, Gll^Fp, Hh, Hh, Gll^Fp, Gs, Rb, Gs, Rb, Re, Re, Gs, Gs, Gd^Vo, Gs, Gs, Gll^Fp, Gll^Fp, Gll^Fp, Gll^Fp, Gll, Gll^Fp, Gll^Fp
Wwf, Gg, Wwg, Wwg, Wwg, Wwg, Wwg, Wwg, Wwg, Wwf, Wwf, Gll^Fp, Wwg, Wwg, Gll^Fp, Gll^Fp, Gll^Fp, Wwg, Wwg, Wwf, Wwf, Gg, Gg, Gll^Fp, Hh, Gs, Gd^Vo, Gs, Gs, Gs, Gs, Re, Re, Gs, Gs, Gs, Gs, Gll^Fp, Gs, Gll, Gll^Fp, Gll, Gll^Fp, Gll^Fp
Wwg, Wwg, Wwg, Wwg, Gll^Fp, Wwg, Gg, Wwg, Gg, Wwf, Wwf, Wwg, Wwf, Wwf, Gll^Fp, Hh, Hh, Gll^Fp, Gll^Fp, Wwg, Wwg, Wwg, Wwg, Gll, Gll, Gs, Gs, Gs, Gs, Gs, Re, Re, Gs, Re, Re, Gs, Gs, Gs, Gs, Gll^Fp, Gll^Fp, Gll^Fp, Gll^Fp, Gll^Fp
Wwg, Wwg, Gg, Gll^Fp, Gll^Fp, Gg, Gs, Gg, Gg, Gll^Fp, Gll^Fp, Gll^Fp, Gll^Fp, Gll^Fp, Hh, Hh, Hh, Gll^Fp, Gll^Fp, Gg, Gg, Wwg, Wwg, Wwf, Gg, Gg, Gs, Gs, Re, Re, Gs, Gs, Gll, Gs, Gs, Re, Gs, Gs, Hh, Gll, Gll^Fp, Gll^Fp, Gd^Vo, Gll^Fp
Gg, Gg, Gll^Fp, Gll^Fp, Gll^Fp, Gll^Fp, Gll^Fp, Gs, Gs, Gs, Gs, Gll^Fp, Gll^Fp, Gll^Fp, Hh, Hh, Gll^Fp, Gll^Fp, Gg, Gg, Gg, Wwg, Wwg, Wwg, Re, Gg, Re, Re, Gll, Gs, Gll^Fp, Gll^Fp, Rb, Gll, Gs, Re, Gs, Gs, Hh, Hh, Hh, Hh, Hh, Hh
Gll^Fp, Gll^Fp, Hh, Hh, Hh, Gll^Fp, Gll^Fp, Gll^Fp, Gs, Gs, Gll^Fp, Gll^Fp, Gll^Fp, Hh, Gll^Fp, Gll^Fp, Gll^Fp, Gs, Gd^Vo, Gs, Gs, Wwf, Wwg, Wwg, Wwg^Bw/, Re, Rb, Gll, Rb, Gll^Fp, Gll^Fp, Rb, Ss, Rb, Gll, Re, Re, Gs, Gs, Hh, Hh, Hh, Hh, Hh
Gs, Gll^Fp, Hh, Hh, Gll^Fp, Hh, Hh, Hh, Gll, Gs, Gs, Gs, Gs, Gll^Fp, Gs, Gll^Fp, Gs, Gs, Gs, Gs, Gs, Re, Re, Wwg^Bw/, Wwg, Wwg, Wwg, Sm, Ss, Rb, Ss, Ss, Gll^Fp, Ss, Ss, Gll, Gll, Re, Re, Co, Co, 4 Ko, Co, Hh
Gg, Gll^Fp, Gll, Gll^Fp, Gll^Fp, Gll^Fp, Hh, Hh, Gll^Fp, Gll, Gll^Fp, Gs, Gll^Fp, Gs, Gs, Gs, Gs, Gs, Gs, Gs, Re, Re, Gs, Rb, Gg, Wwg, Wwg, Wwg, Sm, Ss, Sm, Gll^Fp, Gll^Fp, Rb, Rb, Sm, Gll^Fp, Gll, Re, Gs, Gll, Co, Hh, Hh
Gs, Gll, Gs, Gll, Gll^Fp, Gll^Fp, Gll^Fp, Hh, Hh, Gll^Fp, Gll^Fp, Gll^Fp, Gll^Fp, Hh, Hh, Gs, Gs, Gs, Gs, Gs, Re, Gs, Gs, Gs, Gs, Gg, Wwg, Wwg, Wwg, Ss, Rb, Gll^Fp, Wwf, Ss, Sm, Rb, Gll^Fp, Gs, Re, Gs, Gll^Fp, Co, Gll^Fp, Gll^Fp
Gs, Gs, Gs, Gs, Gs, Gll, Gll, Gd^Vo, Gll^Fp, Gll^Fp, Gll^Fp, Gll^Fp, Gll^Fp, Gll^Fp, Gs, Gs, Gs, Gs, Gs, Gs, Re, Gs, Gs, Gd^Vo, Gs, Gg, Wwf, Wwg, Wwg, Sm, Rb, Rb, Ss, Ss^Vhs, Gll^Fp, Rb, Gll^Fp, Gs, Re, Gs, Gll, Gll^Fp, Gll^Fp, Gll^Fp
Gs, Gs, Gs, Gs, Gs, Gs, Gs, Gs, Gs, Gs, Gs, Gs, Gs, Gs, Gs, Gs, Gs, Gs, Gs, Re, Gs, Gs, Gs, Gs, Gs, Gg, Gg, Wwg, Wwg, Wwg, Wwg, Sm, Wwf, Wwf, Gll^Fp, Gll^Fp, Gs, Gs, Re, Gs, Gs, Gll^Fp, Gll^Fp, Gll^Fp
Gs, Gs, Gs, Gs, Gs, Gs, Gs, Gs, Gs, Gs, Gs, Gs, Gs, Gs, Gs, Gs, Gs, Gs, Re, Re, Gs, Gs, Gll, Gll, Gs, Gs, Gs, Gg, Wwg, Wwg, Wwg, Wwf, Wwf, Gll^Fp, Gll^Fp, Gll^Fp, Gll^Fp, Gll^Fp, Gs, Re, Re, Gs, Gs, Gll^Fp
Gs, Gs, Gs, Gs, Gs, Gs, Gs, Gs, Ce, Ce, Ce, Gs, Gs, Gs, Re, Gs, Re, Re, Gs, Gs, Gs, Gs, Gll, Gll^Fp, Gll^Fp, Gll, Gs, Gg, Gg, Wwg, Wwg, Wwg, Wwf, Gll^Fp, Gll^Fp, Gs, Hh, Gll^Fp, Gs, Gs, Gd^Vo, Re, Re, Gs
Gs, Gs, Gs, Gs, Gs, Gs, Gs, Gs, Gs, 1 Ke, Re, Re, Re, Re, Gs, Re, Gs, Gs, Gs, Gs, Hh, Hh, Hh, Gll^Fp, Gll^Fp, Gs, Gll, Gs, Gll, Gs, Wwrg, Wwg, Wwf, Gll^Fp, Hh, Gll^Fp, Gll^Fp, Hh, Gll^Fp, Gs, Gs, Gs, Gs, Re
Gs, Gs, Gd^Vo, Gs, Re, Gs, Re, Re, Re, Re, Ce, 2 Ke, Ce, Gs, Gs, Gs, Gs, Gs, Gs, Gs, Hh, Hh, Gll^Fp, Gll^Fp, Gll^Fp, Hh, Gll^Fp, Gll, Gll^Fp, Gll^Fp, Hh, Wwf, Wwf, Wwf, Wwf, Wwf, Wwf, Gll^Fp, Gll^Fp, Hh, Gll^Fp, Gll^Fp, Gll^Fp, Gg
Re, Re, Re, Re, Gs, Re, Gs, Gs, Gs, Gs, Gs, Ce, Gs, Gs, Gll^Fp, Gll^Fp, Gll^Fp, Gs, Gs, Gs, Hh, Hh, Gll^Fp, Gll^Fp, Hh, Hh, Hh, Hh, Hh, Hh, Gll^Fp, Wwf, Wwg, Wwf, Hh, Gll^Fp, Gll^Fp, Wwf, Gll^Fp, Gll^Fp, Gll^Fp, Gs, Gll^Fp, Gg
Gs, Gs, Gs, Gs, Gs, Gs, Gll, Gs, Gll^Fp, Gll, Gll^Fp, Gs, Gll^Fp, Gll^Fp, Gll^Fp, Gll^Fp, Gll, Gll^Fp, Hh, Hh, Gll^Fp, Gll^Fp, Gll^Fp, Gll^Fp, Hh, Hh, Gd^Vo, Hh, Gll^Fp, Hh, Gll^Fp, Wwg, Wwg, Wwg, Gll^Fp, Gll^Fp, Gll^Fp, Wwf, Wwf, Wwf, Hh, Gll^Fp, Hh, Gg
Gg, Gs, Gll, Gll, Gll^Fp, Gll^Fp, Gll^Fp, Gll^Fp, Gll^Fp, Gll^Fp, Gll^Fp, Gll^Fp, Gd^Vo, Gll^Fp, Gll^Fp, Gll, Gll^Fp, Gs, Gll^Fp, Gll^Fp, Gll^Fp, Gll^Fp, Hh, Hh, Gll^Fp, Hh, Gll^Fp, Gll^Fp, Hh, Gll^Fp, Gll^Fp, Wwg, Wwg, Wwg, Gll^Fp, Gll^Fp, Gll^Fp, Hh, Wwf, Hh, Gll^Fp, Hh, Hh, Gll^Fp
Gll^Fp, Gll^Fp, Gll^Fp, Gll^Fp, Gll^Fp, Gll^Fp, Gll^Fp, Gll^Fp, Gll^Fp, Gll^Fp, Wwf, Hh, Hh, Gll^Fp, Gll^Fp, Gll, Gll^Fp, Gll^Fp, Gll^Fp, Gll^Fp, Hh, Hh, Gll^Fp, Gll^Fp, Gll^Fp, Hh, Hh, Gll^Fp, Gll^Fp, Gll^Fp, Gg, Wwf, Wwg, Wwg, Gg, Hh, Gll^Fp, Wwf, Hh, Wwf, Gll^Fp, Gll^Fp, Hh, Hh
Gll^Fp, Gll^Fp, Gll^Fp, Gll^Fp, Gll^Fp, Gll^Fp, Gll^Fp, Gll^Fp, Wwf, Gll^Fp, Wwf, Wwf, Hh, Hh, Hh, Hh, Hh, Gll^Fp, Hh, Hh, Hh, Gll^Fp, Gll, Gll^Fp, Hh, Hh, Gll^Fp, Hh, Gll^Fp, Gll, Gg, Wwf, Wwg, Wwg, Gg, Gll^Fp, Gll^Fp, Wwf, Wwf, Hh, Hh, Hh, Hh, Hh
Gll^Fp, Gll^Fp, Gll^Fp, Gll^Fp, Gll^Fp, Gll^Fp, Wwf, Wwf, Wwf, Wwf, Hh, Hh, Hh, Hh, Hh, Hh, Hh, Hh, Hh, Hh, Hh, Hh, Hh, Gll^Fp, Hh, Gll^Fp, Gll^Fp, Gll^Fp, Gg, Gll^Fp, Gg, Wwg, Wwg, Wwg, Gg, Gll^Fp, Gll^Fp, Gll^Fp, Hh, Wwf, Gll^Fp, Hh, Hh, Hh
