Gs, Gs, Gs^Fp, Hh^Fp, Hh^Fp, Gs^Fp, Hh, Gs^Fp, Gs^Fp, Gs^Fp, Hh^Fp, Hh, Mm, Mm, Mm, Xu, Mm^Xm, Mm^Xm, Mm^Xm, Mm^Xm, Mm^Xm, Mm^Xm, Mm^Xm, Xu, Mm^Xm, Xu, Mm^Xm, Xu, Mm^Xm, Xu, Mm^Xm, Mm^Xm, Mm^Xm, Mm^Xm, Mm^Xm, Xu, Mm, Mm, Ww, Ww, Mm, Xu, Mm^Xm, Mm^Xm, Mm^Xm, Mm^Xm
Gs, Gs, Gs^Fp, Hh^Fp, Hh^Fp, Hh, Hh, Gs^Fp, Hh, Gs^Fp, Hh, Hh, Mm, Mm, Mm^Xm, Mm^Xm, Mm^Xm, Mm^Xm, Mm^Xm, Mm^Xm, Mm^Xm, Mm^Xm, Mm^Xm, Mm^Xm, Mm^Xm, Mm^Xm, Mm^Xm, Mm^Xm, Mm^Xm, Mm^Xm, Mm^Xm, Mm^Xm, Mm, Mm^Xm, Mm, Mm^Xm, Mm, Ww^Ii, Ww, Ww, Mm, Mm^Xm, Mm^Xm, Mm^Xm, Mm^Xm, Mm^Xm
Re, Gs, Gs, Gs, Gs^Fp, Hh, Hh^Es, Hh, Gs^Fp, Hh^Fp, Hh, Mm, Mm, Mm, Mm^Xm, Mm^Xm, Mm^Xm, Mm^Xm, Mm^Xm, Mm^Xm, Mm^Xm, Mm^Xm, Mm^Xm, Mm^Xm, Mm^Xm, Mm^Xm, Mm^Xm, Mm^Xm, Mm^Xm, Mm^Xm, Mm, Mm, Mm, Mm, Ww^Ii, Hh^Efm, Gg^Fms, Ww, Hh^Efm, Hh^Ii, Hh^Fds, Mm, Mm, Mm^Xm, Mm^Xm, Mm^Xm
Gs, Re, Gs^Es, Gs, Gs^Fp, Hh, Gs^Fp, Gs^Fp, Hh^Fp, Hh^Fp, Hh, Mm, Mm^Xm, Mm^Xm, Mm^Xm, Mm^Xm, Mm^Xm, Mm^Xm, Mm^Xm, Mm^Xm, Mm^Xm, Mm^Xm, Mm^Xm, Mm^Xm, Xu, Xu, Xu, Mm^Xm, Mm^Xm, Mm^Xm, Mm^Xm, Mm, Mm, Ww, Hh^Efm, Ww, Ww, Ww^Ii, Gg^Efm, Cvr, Kvr, Hh^Fds, Mm, Mm^Xm, Mm^Xm, Mm^Xm
Gs, Re, Gs, Gs, Gs, Gs, Gs^Es, Gs^Fp, Gs^Fp, Hh, Hh, Mm, Mm^Xm, Mm^Xm, Mm^Xm, Mm^Xm, Mm^Xm, Mm^Xm, Mm^Xm, Mm^Xm, Mm^Xm, Mm^Xm, Xu, Xu, Cud, 6 Kud, Cud, Xu, Xu, Mm^Xm, Mm^Xm, Mm^Xm, Mm, Mm, Hh^Fds, Gg^Fms, Gg^Efm, Gg^Efm, Gg, Cvr, Cvr, Hh^Fds, Mm, Mm^Xm, Mm^Xm, Mm^Xm
Gs, Re, Re, Gs, Gs, Gs, Gs, Gs^Fp, Hh^Fp, Hh^Fp, Hh, Mm^Xm, Mm^Xm, Mm^Xm, Mm^Xm, Mm^Xm, Mm^Xm, Mm^Xm, Xu, Xu, Xu, Xu, Xu, Uu, Uu, Cud, Uue, Uh, Xu, Mm^Xm, Mm^Xm, Mm^Xm, Mm^Xm, Mm, Mm, Gg^Fms, Gg, Gg^Ii, Gg^Fds, Gg^Efm, Mm^Fms, Mm, Mm^Xm, Mm^Xm, Mm^Xm, Mm^Xm
Gs^Es, Gs, Gs, Re, Re, Ce, Ce, Gs^Efm, Hh, Hh^Es, Hh, Mm^Xm, Mm^Xm, Mm^Xm, Mm^Xm, Mm^Xm, Xu, Xu, Uu^Vu, Uu^Uf, Uu^Uf, Xu, Xu, Uu, Uu, Uu, Uu, Uh, Uh, Xu, Xu, Mm^Xm, Xu, Mm^Xm, Mm^Xm, Hh, Uu, Hh^Fds, Mm, Hh^Fms, Mm, Mm, Mm^Xm, Mm^Xm, Mm^Xm, Mm^Xm
Gs, Gs, Gs, Ce, Re, 2 Ke, Ce, Gs, Hh, Mm, Mm, Hh, Mm^Xm, Mm^Xm, Mm^Xm, Mm^Xm, Xu, Xu, Uu, Uu, Uu, Xu, Xu, Xu, Uu^Vu, Uu, Uu, Uh, Uu, Xu, Uu, Xu, Uu^Uf, Xu, Xu, Mm^Xm, Uu, Uu, Mm, Mm, Mm^Xm, Mm^Xm, Mm^Xm, Mm^Xm, Mm^Xm, Mm^Xm
Gs^Fp, Gs, Gs, Ce, 1 Ke, Re, Re, Gs, Hh^Es, Mm, Mm^Xm, Mm^Xm, Mm^Xm, Mm^Xm, Xu, Xu, Uue, Uue, Uu, Uu, Uu, Uu, Uu, Xu, Uu, Uu, Xu, Uu, Uu, Uu, Xu, Uu, Uu, Uu^Uf, Xu, Uu, Uu, Xu, Mm^Xm, Mm^Xm, Mm^Xm, Mm^Xm, Mm^Xm, Mm^Xm, Mm^Xm, Mm^Xm
Gs^Fp, Gs^Fp, Gs, Gs^Efm, Gs, Ce, Re, Gs, Gs, Hh, Mm, Mm^Xm, Mm^Xm, Xu, Xu, Uue, Uue, Uu, Uu, Xu, Xu, Uue, Uue, Uu, Uue, Uu, Xu, Xu, Xu, Uu, Xu, Xu, Uu^Vu, Uu, Uu, Uu, Xu, Xu, Xu, Mm^Xm, Xu, Mm^Xm, Mm^Xm, Mm^Xm, Mm^Xm, Mm^Xm
Gs^Fp, Gs^Fp, Gs, Hh^Fp, Gs^Fp, Gs, Gs^Es, Re, Gs, Hh, Hh, Mm^Xm, Xu, Xu, Xu, Xu, Uue, Uu, Uu, Xu, Xu, Uu, Uu, Uue, Xu, Uu^Vu, Xu, Xu, Uue, Xu, Xu, Xu, Xu, Xu, Uu, Uu, Uu, Xu, Xu, Xu, Uh, Xu, Xu, Mm^Xm, Mm^Xm, Mm^Xm
Gs^Fp, Gs^Fp, Gs, Gs, Gs, Gs, Gs, Re, Re, Hh^Es, Hh, Xu, Xu, Xu, Xu, Xu, Xu, Uu, Uu, Xu, Uu, Uu, Uu, Xu, Xu, Xu, Uue, Uue, Uu, Uue, Uu, Uu, Uu, Uu, Uue, Uu, Uu, Uu, Uu, Uh, Uh, Uh, Uu, Xu, Mm^Xm, Mm^Xm
Gs^Fp, Gs^Fp, Gs^Fp, Gs, Gs^Fp, Gs, Hh, Gs, Hh, Re, Re, Uu, Uu^Ii, Xu, Xu, Xu, Xu, Uu, Uu, Uu, Uu, Uu, Uu, Xu, Xu, Uu^Uf, Uu, Uu, Xu, Uu, Uue, Uu, Xu, Uue, Xu, Xu, Xu, Uu, Uu, Uu, Uu, Uu, Uu, Xu, Mm^Xm, Mm^Xm
Hh, Gs^Fp, Hh, Gs^Fp, Hh, Hh, Hh, Mm, Mm, Hh^Es, Uu, Ur^Ii, Ur, Uu, Uu, Uu^Vu, Xu, Xu, Xu, Uu^Vu, Xu, Uu^Es, Uu, Xu, Xu, Uue, Uu, Xu, Uu, Xu, Xu, Xu, Xu, Xu, Uu, Xu, Xu, Uue, Uu, Uu, Uu, Uu, Wwg, Xu, Mm^Xm, Mm^Xm
Hh^Fp, Hh^Fp, Hh, Hh, Mm, Mm, Mm, Mm, Mm, Xu, Xu, Uu^Ii, Uu, Uu, Uu, Uu, Uu, Xu, Xu, Xu, Xu, Uu, Uu, Xu, Xu, Uue, Uue, Uu, Xu, Uu, Uu, Xu, Xu, Xu, Uu, Xu, Xu, Uu^Uf, Uu^Uf, Uh, Uu, Wwg, Xu, Xu, Mm^Xm, Mm^Xm
Hh^Fp, Hh^Fp, Mm, Mm, Mm^Xm, Mm, Mm, Mm, Mm^Xm, Xu, Mm^Xm, Xu, Xu, Uu, Uu, Ur, Ur, Uu, Xu, Xu, Uh, Uu, Uue, Xu, Xu, Xu, Xu, Xu, Xu, Uu, Uu, Uu^Vu, Uu, Uu^Uf, Uu, Xu, Wwg, Wwg, Wwg, Wwg, Wwg, Wwg, Xu, Mm^Xm, Mm^Xm, Mm^Xm
Hh, Hh, Mm, Mm, Mm^Xm, Mm^Xm, Mm^Xm, Mm, Mm^Xm, Mm^Xm, Mm^Xm, Mm^Xm, Mm^Xm, Xu, Xu, Uu, Ur^Ii, Uu, Uu, Uh, Uu, Uu, Xu, Xu, Xu, Xu, Xu, Xu, Uu, Uu^Es, Ur, Ur^Ii, Uu, Ur, Qxu^Bh\, Qxu, Qxu, Wwg, Xu, Wwg, Xu, Xu, Mm^Xm, Mm^Xm, Mm^Xm, Mm^Xm
Mm, Mm, Mm^Xm, Mm^Xm, Mm^Xm, Mm^Xm, Mm^Xm, Mm^Xm, Mm^Xm, Mm^Xm, Mm^Xm, Mm^Xm, Mm^Xm, Xu, Xu, Uu, Uu, Uu, Ur, Uu, Uu, Uu, Uu, Xu, Uu^Uf, Xu, Uu, Uu^Es, Uu, Ur, Uu, Uu, Uu^Uf, Wwg, Qxu, Qxu^Bh\, Ur, Qxu, Xu, Xu, Xu, Mm^Xm, Mm^Xm, Mm^Xm, Mm^Xm, Mm^Xm
Mm, Mm^Xm, Mm^Xm, Mm^Xm, Mm^Xm, Mm^Xm, Mm^Xm, Mm^Xm, Mm^Xm, Mm^Xm, Mm^Xm, Mm^Xm, Mm^Xm, Mm^Xm, Mm^Xm, Xu, Xu, Uu, Uu, Ur, Uu, Ur, Uu, Uu, Ur, Uu, Ur, Uu, Uu, Uu, Xu, Xu, Xu, Xu, Xu, Qxu, Uu, Ur^Ii, Uu, Xu, Xu, Mm^Xm, Mm^Xm, Mm^Xm, Mm^Xm, Mm^Xm
Mm^Xm, Mm^Xm, Mm^Xm, Mm^Xm, Mm^Xm, Mm^Xm, Mm^Xm, Mm^Xm, Mm^Xm, Mm^Xm, Mm^Xm, Mm^Xm, Mm^Xm, Mm^Xm, Mm^Xm, Xu, Xu, Xu, Xu, Uu, Uu^Vu, Uu, Uu, Ur, Uu, Ur^Ii, Uu, Uu, Uu, Xu, Xu, Xu, Mm^Xm, Xu, Xu, Xu, Uu^Es, Ur, Uue, Xu, Xu, Xu, Xu, Mm^Xm, Mm^Xm, Mm^Xm
Mm^Xm, Mm^Xm, Mm^Xm, Mm^Xm, Mm^Xm, Mm^Xm, Mm^Xm, Mm^Xm, Mm^Xm, Mm^Xm, Mm^Xm, Mm^Xm, Mm^Xm, Mm^Xm, Mm^Xm, Mm^Xm, Xu, Xu, Xu, Xu, Xu, Xu, Xu, Uu, Xu, Uu, Xu, Uu, Uu^Uf, Uu, Xu, Xu, Mm^Xm, Mm^Xm, Xu, Xu, Uu, Ur, Uu, Uue, Uu, Cud, 3 Kud, Xu, Mm^Xm, Mm^Xm
Mm^Xm, Mm^Xm, Mm^Xm, Mm^Xm, Mm^Xm, Mm^Xm, Mm^Xm, Mm^Xm, Mm^Xm, Mm^Xm, Mm^Xm, Mm^Xm, Mm^Xm, Mm^Xm, Mm^Xm, Mm^Xm, Xu, Xu, Xu, Xu, Xu, Xu, Xu, Uu, Xu, Xu, Xu, Uu^Uf, Uu^Uf, Uu, Uue, Xu, Mm^Xm, Mm^Xm, Mm^Xm, Xu, Uu^Es, Uu, Uu, Uue, Uu, Cud, Cud, Xu, Mm^Xm, Mm^Xm
Mm^Xm, Mm^Xm, Mm^Xm, Mm^Xm, Mm^Xm, Mm^Xm, Mm^Xm, Mm^Xm, Xu, Xu, Xu, Mm^Xm, Xu, Mm^Xm, Xu, Xu, Uu, Uu, Cud, Xu, Xu, Xu, Uu, Uu, Xu, Xu, Xu, Xu, Uu, Uu, Uue, Xu, Mm^Xm, Mm^Xm, Mm^Xm, Xu, Uu^Vu, Uu, Ur, Uu, Uu, Uu, Xu, Xu, Mm^Xm, Mm^Xm
Mm^Xm, Mm^Xm, Mm^Xm, Mm^Xm, Mm^Xm, Mm^Xm, Mm^Xm, Xu, 5 Kud, Cud, Uu, Xu, Xu, Xu, Xu, Uue, Uu, Uu, Cud, 4 Kud, Xu, Xu, Xu, Uu, Uu, Uu, Uu, Xu, Uu, Uu^Es, Xu, Xu, Mm^Xm, Mm^Xm, Mm^Xm, Xu, Xu, Uu, Ur^Ii, Uu, Xu, Uu^Vu, Xu, Mm^Xm, Mm^Xm, Mm
Mm^Xm, Mm^Xm, Mm^Xm, Mm^Xm, Mm^Xm, Mm^Xm, Mm^Xm, Xu, Cud, Cud, Uu, Uu, Xu, Xu, Xu, Uue, Uu, Uu, Uu, Cud, Xu, Xu, Xu, Uu^Uf, Uu^Uf, Xu, Xu, Uu, Uu, Uu^Vu, Xu, Xu, Mm^Xm, Mm^Xm, Mm^Xm, Xu, Xu, Uu, Ur, Uu, Xu, Xu, Xu, Mm^Xm, Mm, Mm
Mm^Xm, Mm^Xm, Mm^Xm, Mm^Xm, Mm^Xm, Mm^Xm, Xu, Xu, Uu, Uu, Uu, Uu^Vu, Xu, Xu, Uue, Uu, Uu, Uu, Uu^Vu, Xu, Xu, Xu, Xu, Xu, Xu, Xu, Xu, Uue, Uu^Uf, Xu, Mm^Xm, Mm^Xm, Mm^Xm, Mm^Xm, Mm^Xm, Mm^Xm, Xu, Uu, Ur, Uu, Uu, Xu, Xu, Mm, Hh, Hh
Mm^Xm, Mm^Xm, Mm^Xm, Mm^Xm, Mm^Xm, Mm^Xm, Xu, Uu, Uu, Uu, Xu, Xu, Xu, Uu, Uue, Uu, Xu, Uu, Uu, Uu, Uu, Xu, Uu^Vu, Xu, Uu, Xu, Uue, Uue, Uu^Uf, Xu, Mm^Xm, Mm^Xm, Mm^Xm, Mm^Xm, Mm^Xm, Mm^Xm, Xu, Uu, Uu, Uu, Ur, Uu, Gs, Hh, Hh, Hh
Mm^Xm, Mm^Xm, Mm^Xm, Mm^Xm, Mm^Xm, Mm^Xm, Xu, Uu, Uu, Uh, Xu, Xu, Xu, Uue, Uue, Xu, Xu, Xu, Uu, Uu, Uu, Uu, Uu, Uu, Uu, Uu, Uu, Uu, Xu, Xu, Mm, Mm, Mm, Mm^Xm, Mm^Xm, Mm^Xm, Mm^Xm, Xu, Xu, Uu, Gs, Re, Re, Gs, Gs^Es, Hh
Mm^Xm, Mm^Xm, Mm^Xm, Mm^Xm, Mm^Xm, Mm^Xm, Xu, Uue, Uu, Uh, Xu, Xu, Xu, Uu, Uue, Uu, Uu, Uu, Uu, Uu, Uu, Uu, Xu, Uu, Xu, Uh, Xu, Uu, Uh, Hh, Mm, Mm, Mm, Mm^Xm, Mm^Xm, Mm^Xm, Mm^Xm, Mm^Xm, Mm^Xm, Xu, Hh, Gs, Gs, Re, Gs, Gs^Fp
Mm^Xm, Mm^Xm, Mm^Xm, Mm^Xm, Mm^Xm, Mm^Xm, Xu, Uue, Uue, Uu, Uu, Uh, Uu, Uue, Uue, Uu, Uu, Uu, Uu, Uu, Uu^Uf, Xu, Xu, Xu, Mm^Xm, Xu, Mm^Xm, Xu, Xu, Xu, Mm^Xm, Mm, Mm^Xm, Mm^Xm, Mm^Xm, Mm^Xm, Mm^Xm, Mm^Xm, Mm, Xu, Hh, Gs^Es, Gs, Re, Re, Gs
Mm^Xm, Mm^Xm, Mm^Xm, Mm^Xm, Mm^Xm, Mm^Xm, Mm^Xm, Xu, Uu, Uue, Uu, Uu, Uu^Vu, Uu, Uu, Uue, Uu, Uue, Uue, Uu, Xu, Xu, Mm^Xm, Mm^Xm, Mm^Xm, Mm^Xm, Mm^Xm, Mm^Xm, Mm^Xm, Mm^Xm, Mm^Xm, Mm^Xm, Mm^Xm, Mm^Xm, Mm^Xm, Mm^Xm, Mm^Xm, Mm^Xm, Mm, Mm, Hh, Gs^Fp, Gs^Es, Gs, Gs, Re
Mm^Xm, Mm^Xm, Mm^Xm, Mm^Xm, Mm^Xm, Mm^Xm, Mm^Xm, Xu, Xu, Xu, Xu, Xu, Xu, Xu, Xu, Xu, Xu, Xu, Xu, Xu, Mm^Xm, Mm^Xm, Mm^Xm, Mm^Xm, Mm^Xm, Mm^Xm, Mm^Xm, Mm^Xm, Mm^Xm, Mm^Xm, Mm^Xm, Mm^Xm, Mm^Xm, Mm^Xm, Mm^Xm, Mm^Xm, Mm, Mm, Hh, Hh, Hh, Gs^Fp, Gs^Fp, Gs, Gs, Gg
Mm^Xm, Mm^Xm, Mm^Xm, Mm^Xm, Mm^Xm, Mm^Xm, Mm^Xm, Mm^Xm, Mm^Xm, Mm^Xm, Mm^Xm, Mm^Xm, Mm^Xm, Mm^Xm, Mm^Xm, Mm^Xm, Mm^Xm, Mm^Xm, Mm^Xm, Mm^Xm, Mm^Xm, Mm^Xm, Mm^Xm, Mm^Xm, Mm^Xm, Mm^Xm, Mm^Xm, Mm^Xm, Mm^Xm, Mm^Xm, Mm^Xm, Mm^Xm, Mm^Xm, Mm^Xm, Mm^Xm, Mm, Mm, Mm, Hh, Hh, Mm, Gs^Fp, Gs^Fp, Gs^Fp, Gs^Fp, Gs
