Gs, Gs, Gs, Gs, Gs, Gll^Fp, Hh, Hh, Hh, Mm, Mm, Mm, Mm, Mm, Xu, Xu, Urb, Uu^Vud, Xol, Cud, Cud, Cud, Cud, Cud, Xol, Uu^Vud, Urb, Uu, Xu, Mm, Mm, Mm, Mm, Mm, Mm, Mm, Mm, Mm, Mm, Mm
Gs, Gs, Gs, Gs, Gs, Gs^Fms, Gll^Fp, Gll^Fp, Gll^Fp, Hh, Hh, Mm, Mm, Mm, Xu, Uu^Vud, Uu, Urb, Urb, Cud, Cud, 2 Kud, Cud, Cud, Urb, Urb, Uu, Uu^Vud, Xu, Mm, Mm, Mm, Mm, Mm, Mm, Mm, Mm, Mm, Mm, Mm
Gs, Gs, Gs, Gs^Efm, Gs^Efm, Gs, Gs, Gs^Fms, Gd^Vo, Gll^Fp, Gs^Fms, Hh, Hh, Mm, Xol, Cud, Uu, Urb, Uu^Vud, Xol, Cud, Cud, Cud, Xol, Uu^Vud, Urb, Uu, Cud, Xol, Mm, Mm, Mm, Mm, Chr, Chr, Chr, Chr, Mm, Mm, Mm
Re, Gd^Vo, Gs, Gs, Gs, Gs, Gs^Efm, Gs, Gs, Gs, Gs, Gs^Fms, Hh, Hh, Hh, Uu, Urb, Urb, Urb, Urb, Uu^Vud, Urb, Uu^Vud, Urb, Urb, Urb, Urb, Uu, Mm, Mm, Mm, Mm, Hh, Mm, Chr, Khr, Chr, Mm, Mm, Mm
Gs, Re, Re, Gs, Gs, Gs, Gs, Gs, Re, Gs, Re, Gs, Re, Re, Rp, Rp, Uu, Uu, Uu, Urb, Urb, Urb, Urb, Urb, Uu, Uu, Uu, Urb, Rp, Mm, Hh, Hh, Gs^Fms, Hh, Hh, Chr, Mm, Mm, Mm, Mm
Gs, Gs, Gs, Re, Ce, Ce, Ce, Re, Gs, Re, Gs, Re, Gs, Hh, Hh, Hh, Xu, Cud, Uu^Vud, Uu, Uu, Urb, Uu, Uu, Uu^Vud, Cud, Xol, Mm, Mm, Rp, Re^Efm, Gs^Em, Gd^Vo, Gll^Fp, Hh^Es, Mm, Mm, Mm, Mm, Mm
Gs, Gs, Gs, Gs, Ce, 1 Ke, Ce, Gs, Gs, Gs, Gs^Fms, Gs, Gll^Fp, Hh, Hh, Mm, Mm, Xu, Xu, Cud, Uu, Urb, Uu, Cud, Xu, Xu, Mm, Mm, Mm, Hh, Gs, Gs, Gs, Gll^Fp, Hh, Hh^Edb, Mm, Mm, Mm, Mm
Gs, Gs, Gs, Gs, Gs, Ce, Gs, Gs, Gs, Hh, Hh, Hh, Gs^Fms, Hh, Hh, Mm, Mm, Mm, Mm, Xol, Uu, Urb, Uu, Xol, Mm, Mm, Mm, Mm, Hh, Gll^Fp, Gs, Gs, Gs^Fms, Gll^Fp, Hh, Mm, Mm, Mm, Mm, Mm
Hh, Hh, Gs, Gs, Gs, Re, Gs, Gs, Gs, Hh, Hh^Es, Hh, Hh, Hh, Hh, Hh, Mm, Mm, Mm, Mm, Hh, Rp, Hh, Mm, Mm, Mm, Mm, Hh, Gs^Fms, Gs^Fms, Gs^Efm, Gs, Gs^Em, Gll^Fp, Hh, Mm, Mm, Mm, Mm, Mm
Hh, Hh, Gs, Gs^Efm, Gs, Re, Gs, Gs, Gs, Gs, Gs, Hh, Gd^Vo, Hh^Es, Hh, Mm, Mm, Mm, Mm, Hh, Hh^Es, Rp, Hh, Mm, Mm, Mm, Mm, Hh, Gll^Fp, Gs^Em, Gs, Gs, Gs^Efm, Gll^Fp, Gs^Fms, Hh, Hh^Edb, Mm, Mm, Mm
Gll^Fp, Hh, Hh, Gs, Gs, Re, Re, Gs, Gs, Gs^Efm, Gs^Efm, Gs, Gs, Hh, Hh, Mm, Mm, Mm, Mm, Hh, Hh, Re, Hh, Mm, Mm, Mm, Mm, Hh, Gll^Fp, Gd^Vo, Gll^Fp, Gs, Gs, Gs^Em, Hh, Hh, Mm, Mm, Mm, Mm
Gll^Fp, Hh, Hh, Gs, Gs, Gs, Gs, Re, Re, Gs, Gs, Gs, Gs, Hh, Hh^Es, Mm, Mm, Mm, Hh, Hh, Gs^Es, Re, Gs, Hh, Mm, Mm, Mm, Hh^Es, Hh, Gll^Fp, Hh, Hh, Hh, Hh, Hh, Mm, Mm, Mm, Mm, Mm
Gll^Fp, Gs^Fms, Gs^Em, Gs, Hh, Gs, Gs, Re, Gs^Es, Re, Re, Gs, Gs, Hh, Hh, Hh, Hh, Hh, Hh, Hh, Gs, Re, Gs, Hh, Hh, Mm, Mm, Mm, Mm, Hh, Gll^Fp, Gll^Fp, Gs^Fms, Hh, Hh, Mm, Mm, Mm, Mm, Mm
Wwrg, Gll^Fp, Gs^Fms, Gs^Em, Hh, Hh, Gs, Re, Gs, Gs, Gs, Re, Re, Gs, Gs, Hh, Gs, Gll^Fp, Gs, Gs^Efm, Gs, Re, Gs, Gs, Hh, Mm, Hh, Mm, Hh, Hh, Gs^Fms, Gs, Gs, Gs, Gll^Fp, Hh, Hh, Mm, Mm, Mm
Wwrg, Wwg, Wwg, Gd^Vo, Hh, Hh, Gs, Re, Gs, Gs, Gs^Efm, Gs, Gs, Re, Re, Gs, Gs, Gs, Gs, Gs, Gs, Re, Gs, Gs^Efm, Gs, Gll^Fp, Gll^Fp, Hh, Gs, Gs, Gs, Gs, Gs, Gs, Gs, Gd^Vo, Gll^Fp, Hh^Es, Hh, Mm
Mm, Wwg, Wwg, Hh, Hh, Gs^Fms, Gs, Re, Gs, Gs, Gs^Efm, Gs, Gs, Gs, Gs, Re, Re, Gd^Vo, Re, Gs, Re, Re, Re, Gs^Es, Re, Gd^Vo, Re, Gs, Gs, Gs^Efm, Gs, Gs^Efm, Gs, Gs, Gs, Gll^Fp, Gll^Fp, Hh, Gll^Fp, Hh
Mm, Wwf, Wwg, Wwf, Hh, Gll^Fp, Gs, Re, Re, Gs, Gll^Fp, Gs^Efm, Hh, Gs, Gs, Gs, Gs, Re, Gs^Es, Re, Re, Re, Re, Re, Gs, Re, Gs, Re, Re, Gs, Re, Gs, Gs, Gs^Fms, Gs^Fms, Gs, Gs^Em, Gs^Fms, Gll^Fp, Hh
Mm, Mm, Wwg, Wwg, Hh, Gs^Fms, Gll^Fp, Gs, Re, Gs, Gs, Gll^Fp, Gs^Fms, Hh, Hh, Gs, Gs^Efm, Gs, Gs, Gs, Gs, Re, Gs, Gs, Gs, Gs, Gs, Gs, Gs, Re, Gs^Es, Re, Re, Gs, Gs, Gs, Gs, Gs^Fms, Gll^Fp, Hh
Mm, Hh, Wwf, Wwf, Hh, Gll^Fp, Gs^Fms, Gs, Gs, Re, Gs, Gll^Fp, Hh, Hh^Es, Hh, Gs^Fms, Gll^Fp, Gs^Fms, Gll^Fp, Gs, Ce, Ce, Ce, Gs, Gs, Gs, Gll^Fp, Gll^Fp, Gs^Fms, Gs, Gs, Gs, Gs, Re, Gd^Vo, Gs, Gs, Gs, Gs^Fms, Gll^Fp
Mm, Hh, Wwf, Wwf, Wwf, Hh, Gll^Fp, Gll^Fp, Gs, Re, Gs^Es, Gll^Fp, Gs^Fms, Hh, Gll^Fp, Hh, Hh, Hh, Hh, Gs, Gs, 3 Ke, Ce, Ce, Gs, Gs, Gll^Fp, Gll^Fp, Hh, Gll^Fp, Gs^Fms, Gs, Gs, Re, Re, Gs, Ce, Gs, Gs, Gs
Mm, Hh, Hh, Wwf, Wwg, Wwg, Wwf, Gll^Fp, Gs^Em, Re, Re, Gs, Gs, Gll^Fp, Gs^Em, Gll^Fp, Hh^Es, Hh, Gll^Fp, Gs^Fms, Gs, Ce, Gs, Gs, Gs, Gs, Gll^Fp, Gs^Fms, Hh, Gll^Fp, Gll^Fp, Gll^Fp, Gs, Gs, Gs, Ce, 4 Ke, Ce, Re, Re
Mm, Mm, Hh, Hh^Es, Hh, Wwg, Wwg, Gll^Fp, Gs^Fms, Gs, Gs, Re, Re, Gs, Gs, Gs^Fms, Hh, Hh, Gll^Fp, Gll^Fp, Gs, Re, Gs, Gs, Gs, Gs^Fms, Hh, Hh^Es, Hh, Hh, Gs^Fms, Gll^Fp, Gll^Fp, Gs, Gs, Ce, Ce, Ce, Gs, Gs
Mm, Mm, Mm, Mm, Mm, Wwf, Wwg, Wwg, Wwg, Gs^Fms, Gs, Gd^Vo, Re, Gs, Gll^Fp, Hh, Gll^Fp, Gs^Fms, Gs, Gs, Gd^Vo, Re, Gs, Gs^Efm, Gs, Gll^Fp, Gll^Fp, Hh, Hh, Hh, Hh, Gs^Fms, Gll^Fp, Gs, Gs, Gs, Gs, Gs, Gs, Gs
Mm, Mm, Mm, Mm, Mm, Mm, Hh, Wwg, Wwg, Wwg, Wwg, Gs, Re, Gs, Gs^Fms, Gll^Fp, Gs, Gs, Gs, Gs, Re, Re, Gs, Gs, Gll^Fp, Gs^Fms, Hh, Hh, Mm, Hh, Hh, Gll^Fp, Hh, Gll^Fp, Gs^Fms, Gs, Gs^Em, Gs, Gll^Fp, Gs
Mm, Mm, Mm, Mm, Mm, Mm, Mm, Hh, Hh, Wwg, Wwg, Gs, Re, Gs, Gll^Fp, Hh, Gs, Gs, Re, Re, Gs, Gs, Gs, Gs, Gs^Fms, Gll^Fp, Hh, Mm, Mm, Mm, Mm, Hh, Hh, Gs^Fms, Gll^Fp, Gll^Fp, Gs^Fms, Gll^Fp, Gs^Fms, Gll^Fp
Mm, Mm, Mm, Mm, Mm, Mm, Hh, Mm, Hh, Wwg, Wwg, Gs, Re, Gs, Gs^Fms, Gll^Fp, Gs, Re, Gs^Efm, Gs, Gs, Gs, Gs^Fms, Gll^Fp, Gll^Fp, Hh, Mm, Mm, Mm, Mm, Mm, Hh, Gll^Fp, Gll^Fp, Hh, Hh, Hh^Es, Hh, Hh, Gll^Fp
Mm, Mm, Hh, Hh, Hh, Hh, Gll^Fp, Hh, Hh^Es, Wwg, Wwg, Gs, Re, Gs, Gs, Gs, Gs, Re, Gs, Gs, Gs^Fms, Gll^Fp, Gs^Fms, Gll^Fp, Hh, Hh, Hh, Mm, Mm, Mm, Mm, Hh, Hh, Gll^Fp, Gll^Fp, Hh, Gd^Vo, Hh, Hh, Gll^Fp
Mm, Hh, Hh^Es, Gll^Fp, Hh, Hh, Gll^Fp, Gll^Fp, Gll^Fp, Wwg, Wwg, Gs, Gs, Re, Re, Gs, Gs^Es, Re, Gs, Gs, Gll^Fp, Gll^Fp, Gll^Fp, Hh, Hh, Gll^Fp, Hh, Mm, Mm, Mm, Mm, Mm, Mm, Hh, Hh, Hh, Hh, Hh, Mm, Hh
Hh, Hh, Hh, Gll^Fp, Gd^Vo, Gll^Fp, Gs, Gs, Gs, Wwg, Wwg, Gs^Efm, Gs^Efm, Gs^Es, Re, Re, Re, Re, Gs, Gs, Gll^Fp, Gll^Fp, Gd^Vo, Gll^Fp, Gll^Fp, Hh, Hh, Mm, Mm, Mm, Mm, Mm, Mm, Mm, Mm, Hh, Mm, Mm, Mm, Mm
Gll^Fp, Gll^Fp, Gs^Fms, Gll^Fp, Gs^Fms, Gs, Gs^Efm, Gs^Efm, Gs, Wwg, Wwg, Wwg, Wwg^Bsb/, Re, Gs, Gs, Gs, Re, Re, Gs, Gs, Gll^Fp, Gs, Gs^Em, Gs^Fms, Gll^Fp, Gs^Fms, Hh, Mm, Mm, Mm, Mm, Mm, Mm, Mm, Mm, Mm, Mm, Mm, Mm
Gs^Fms, Gs^Fms, Gs, Gs^Em, Gs, Gs, Gs, Gs, Gs, Gs, Re, Wwg^Bsb/, Wwg, Gd^Vo, Gs, Gs, Gs, Gs^Es, Re, Gs, Ce, Gs, Gs^Efm, Gs, Gll^Fp, Gll^Fp, Hh, Hh, Hh, Mm, Mm, Mm, Mm, Mm, Mm, Mm, Mm, Mm, Mm, Mm
Gs^Fms, Gs^Fms, Gs, Gs, Gs, Gs, 6 Ke, Ce, Re, Re, Gs, Wwg, Wwg, Wwg, Gs, Gs^Efm, Gs^Efm, Gs, Gs, Re, 5 Ke, Ce, Gs, Gs, Gd^Vo, Gll^Fp, Gs^Fms, Gs^Fms, Hh, Mm, Mm, Mm, Mm, Mm, Mm, Mm, Mm, Mm, Mm, Mm
Gs^Fms, Gs, Gs, Gs^Es, Re, Ce, Ce, Ce, Ce, Gs, Gs, Gs, Wwg, Wwg, Gs, Gs, Gs^Efm, Gs, Gs, Ce, Ce, Ce, Gs, Gs, Gs, Gll^Fp, Gll^Fp, Gs^Fms, Hh, Hh, Hh, Mm, Mm, Mm, Mm, Mm, Mm, Mm, Mm, Mm
Gs, Gs, Re, Re, Gs, Gs, Gs, Gs, Gs, Gs, Gs, Gs, Wwg, Wwg, Wwg, Gs, Gs, Gs, Gs, Gs, Gs, Re, Gs, Gs, Gs, Gs, Gll^Fp, Hh, Hh, Hh, Hh, Mm, Mm, Mm, Mm, Mm, Mm, Mm, Mm, Mm
