Mm, Mm, Mm, Mm, Mm, Mm, Mm, Mm, Mm, Mm, Mm, Mm, Mm, Mm, Xu, Xu, Urb, Uu^Vud, Xol, Cud, Cud, Cud, Cud, Cud, Xol, Uu^Vud, Urb, Uu, Xu, Mm, Mm, Mm, Mm, Mm, Mm, Mm, Mm, Mm, Mm, Mm
Hh, Mm, Mm^Vhh, Mm, Mm, Mm, Mm, Mm, Mm, Mm, Hh^Vhh, Mm, Mm, Mm, Xu, Uu^Vud, Uu, Urb, Urb, Cud, Cud, 3 Kud, Cud, Cud, Urb, Urb, Uu, Uu^Vud, Xu, Mm, Mm, Mm, Mm, Mm, Mm, Mm, Mm, Mm, Mm, Mm
Gs, Hh, Hh, Mm, Mm, Mm, Mm, Mm, Hh, Hh^Fp, Gs^Fms, Mm, Mm, Mm, Xol, Cud, Uu, Urb, Uu^Vud, Xol, Cud, Cud, Cud, Xol, Uu^Vud, Urb, Uu, Cud, Xol, Mm, Mm, Mm, Mm, Mm, Chr, Chr, Mm, Mm, Mm, Mm
Re, Gs, Gs, Hh, Mm, Mm, Hh^Efm, Hh, Gs, Gs, Gs, Gs^Fms, Hh, Mm, Mm, Uu, Urb, Urb, Urb, Urb, Uu^Vud, Urb, Uu^Vud, Urb, Urb, Urb, Urb, Uu, Mm, Mm, Mm, Mm, Hh^Vhh, Mm, Chr, Khr, Chr, Mm, Mm, Mm
Gs, Re, Re, Gs, Gs, Mm, Gs, Gs, Re, Gs, Re, Gs, Re, Re, Rp, Rp, Uu, Uu, Uu, Urb, Urb, Urb, Urb, Urb, Uu, Uu, Uu, Urb, Rp, Mm, Hh, Hh, Gs^Fms, Hh, Hh, Chr, Mm, Mm, Mm, Mm
Hh, Gs, Gs, Re, Re, Gs, Re, Re, Ce, Re, Gs, Re, Gs, Hh, Mm, Mm, Xu, Cud, Uu^Vud, Uu, Uu, Urb, Uu, Uu, Uu^Vud, Cud, Xol, Mm, Mm, Rp, Re^Efm, Gs^Em, Gs, Gs^Fp, Hh^Es, Mm, Mm, Mm, Mm, Mm
Mm, Hh, Hh, Gs, Gs, Re, 1 Ke, Ce, Gs, Gs, Gs^Fms, Gs, Gs^Fp, Mm, Mm, Mm, Mm, Xu, Xu, Cud, Uu, Urb, Uu, Cud, Xu, Xu, Mm, Mm, Mm, Hh, Gs, Re, Gs, Gs^Fp, Hh, Hh^Edb, Mm, Mm, Mm, Mm
Mm, Mm, Hh, Hh, Gs, Re, Ce, Ce, Gs, Hh, Mm, Hh, Mm, Hh, Hh, Mm, Mm, Mm, Mm, Xol, Uu, Urb, Uu, Xol, Mm, Mm, Mm, Mm, Hh, Gll^Fp, Gs, Gs, Gs^Fms, Gs^Fp, Hh, Mm, Mm, Mm, Mm, Mm
Mm, Mm, Hh, Hh, Gs, Re, Ce, Gs, Hh, Hh, Mm^Es, Mm, Mm, Mm, Hh, Hh^Vhh, Mm, Mm, Mm, Mm, Hh, Rp, Hh, Mm, Mm, Mm, Mm, Hh, Gs^Fms, Gs^Fms, Gs^Efm, Re, Gs^Em, Gs^Fp, Hh, Mm, Mm, Mm, Mm, Mm
Mm, Mm, Mm, Hh^Efm, Gs, Re, Gs, Gs, Gs, Hh, Hh, Mm, Mm, Mm^Es, Mm, Mm, Mm, Mm, Mm, Mm, Hh^Es, Rp, Hh, Mm, Mm, Mm, Mm, Hh, Gs^Fp, Gs^Em, Gs, Gs, Gs^Efm, Gs^Fp, Gs^Fms, Hh, Hh^Edb, Mm, Mm, Mm
Mm^Fp, Mm, Mm, Hh, Hh, Re, Re, Gs, Gs, Gs^Efm, Hh^Efm, Mm, Mm, Mm, Mm, Mm, Mm, Mm, Mm, Mm, Hh, Re, Hh, Mm, Mm, Mm, Mm, Hh^Vhh, Gs^Fp, Gs, Gs^Fp, Re, Re, Gs^Em, Hh, Hh, Mm, Mm, Mm, Mm
Mm^Fp, Mm, Mm, Mm, Mm, Hh, Hh, Re, Re, Gs, Gs, Hh, Hh, Mm, Hh^Es, Mm, Mm, Mm, Mm, Mm, Hh^Es, Re, Hh, Mm, Mm, Mm, Mm, Hh^Es, Hh, Gs^Fp, Hh, Hh, Re, Hh, Mm, Mm, Mm, Mm, Mm, Mm
Hh^Fp, Hh^Fms, Mm, Mm, Mm, Mm, Mm, Re, Gs^Es, Re, Re, Gs, Gs, Hh, Hh^Fp, Mm, Hh^Vhh, Mm, Mm, Mm, Hh, Re, Hh, Mm, Mm, Mm, Mm, Mm, Mm, Hh, Hh^Fp, Hh^Fp, Re^Fms, Hh, Mm, Mm, Mm, Mm, Mm, Mm
Wwrg, Hh^Fp, Hh^Fms, Hh^Em, Mm, Mm, Hh, Re, Gs, Gs, Gs, Re, Re, Gs, Gs, Hh^Fp, Gs^Fp, Hh^Fp, Mm, Hh^Efm, Hh, Re, Hh, Mm, Mm, Mm, Mm, Mm, Mm, Mm, Hh^Fms, Re, Hh, Mm, Mm, Mm, Mm, Mm, Mm, Mm
Wwrg, Wwg, Wwg, Hh, Hh^Vhh, Mm, Hh, Re, Mm, Hh, Hh^Efm, Gs, Gs, Re, Re, Gs, Gs, Hh, Hh, Hh, Hh, Re, Hh, Hh^Efm, Mm, Mm, Mm, Mm, Hh, Hh, Re, Re, Gs, Hh, Hh, Hh^Vhh, Mm, Mm, Mm, Mm
Mm, Wwg, Wwg, Hh, Hh, Hh^Fms, Hh, Re, Mm, Mm, Mm, Hh, Mm, Hh, Hh, Re, Re, Gs, Re, Hh, Re, Re, Re, Hh^Es, Mm, Mm, Mm, Hh, Gs, Gs^Efm, Re, Gs^Efm, Gs, Hh, Hh, Hh^Fp, Hh^Fp, Mm, Mm, Mm
Mm, Wwf, Wwg, Wwf, Hh, Hh^Fp, Gs, Re, Re, Mm, Hh^Fp, Mm, Mm, Mm, Mm, Hh, Hh, Re, Gs^Es, Re, Re, Re, Re, Hh, Hh, Mm, Hh, Hh, Re, Gs, Re, Gs, Gs, Gs^Fms, Gs^Fms, Hh, Hh^Em, Hh^Fms, Mm, Mm
Mm, Mm, Wwg, Wwg, Hh, Hh^Fms, Gs, Hh, Re, Mm, Mm, Hh^Fp, Hh^Fms, Mm, Mm, Mm, Mm, Hh, Hh, Gs, Gs, Re, Gs, Gs, Hh, Hh, Re, Re, Gs, Re, Gs^Es, Re, Re, Gs, Gs, Gs, Gs, Gs^Fms, Hh^Fp, Mm
Mm, Hh, Wwf, Wwf, Gs, Gs, Hh^Fms, Hh, Hh, Re, Mm, Hh^Fp, Hh^Vhh, Mm, Mm, Mm, Mm, Mm, Hh^Fp, Hh, Ce, Ce, Ce, Gs, Re, Re, Gs, Gs, Hh, Gs, Gs, Gs, Gs, Re, Gs, Gs, Gs, Gs, Gs^Fms, Hh^Fp
Mm, Hh, Wwf, Wwf, Wwf, Hh, Hh^Fp, Hh^Fp, Hh, Re, Hh^Es, Hh^Fp, Hh^Fms, Hh, Gll^Fp, Mm, Mm, Mm, Hh, Hh, Gs, 4 Ke, Ce, Ce, Gs, Gs, Hh, Hh, Mm, Gs^Fp, Gs^Fms, Gs, Gs, Re, Re, Gs, Ce, Gs, Gs, Gs
Mm, Hh, Gs, Wwf, Wwg, Wwg, Wwf, Hh^Fp, Hh^Em, Re, Re, Hh, Hh, Gll^Fp, Mm, Mm, Mm, Mm, Hh^Fp, Hh^Fms, Gs, Ce, Gs, Gs, Hh, Hh, Mm, Mm, Mm, Mm, Hh^Fp, Gs^Fp, Gs, Gs, Gs, Ce, 5 Ke, Ce, Re, Re
Mm, Hh, Gs, Hh^Es, Mm, Wwg, Wwg, Hh^Fp, Hh^Fms, Hh, Mm, Re, Re, Hh, Mm, Mm, Mm, Hh^Vhh, Hh^Fp, Hh^Fp, Gs, Re, Gs, Hh, Hh, Mm, Mm, Mm, Mm, Mm, Mm, Hh^Fp, Hh^Fp, Gs, Gs, Ce, Ce, Ce, Gs, Gs
Mm, Gs, Mm, Mm, Mm, Wwf, Wwg, Wwg, Wwg, Hh^Fms, Hh, Mm, Re, Hh, Hh^Fp, Mm, Hh^Fp, Hh^Fms, Hh, Hh, Gs, Re, Gs, Hh^Efm, Hh, Mm, Mm, Mm, Mm, Mm, Hh, Hh^Fms, Re, Gs, Gs, Gs, Gs, Gs, Hh, Gs
Mm, Cte, Mm, Mm, Mm, Mm, Hh, Wwg, Wwg, Wwg, Wwg, Mm, Re, Hh, Hh^Fms, Mm, Hh, Hh, Gs, Gs, Re, Re, Re, Hh, Hh^Fp, Mm, Mm, Mm, Hh, Hh, Gs, Gs, Hh, Hh^Fp, Hh^Fms, Gs^Fp, Hh^Em, Hh, Hh^Fp, Hh
Cte, Cte, Cte, Mm, Mm, Mm, Mm, Hh, Hh, Wwg, Wwg, Mm, Re, Hh, Hh^Fp, Mm, Gs^Fp, Gs^Fp, Re, Re, Gs, Gs, Hh, Re, Gs, Hh, Hh, Mm, Hh, Re, Hh, Hh, Mm, Hh^Fms, Hh^Fp, Hh^Fp, Gs^Fms, Gll^Fp, Hh^Fms, Hh^Fp
Mm, 2 Kte, Cte, Mm, Mm, Mm, Hh^Vhh, Mm, Hh, Wwg, Wwg, Hh, Re, Hh, Hh^Fms, Hh^Fp, Gs^Fp, Re, Gs^Efm, Gs, Hh, Hh, Hh^Fms, Hh^Fp, Hh, Gs, Re, Re, Re, Gs, Hh, Hh, Mm, Mm, Mm, Hh^Vhh, Hh^Es, Hh, Hh, Hh^Fp
Mm, Cte, Hh, Hh, Hh, Hh, Gs^Fp, Hh, Hh^Es, Wwg, Wwg, Hh, Re, Gs, Gs^Fp, Gs^Fp, Gs^Fp, Re, Gs, Gs^Fp, Hh^Fms, Hh^Fp, Hh^Fms, Hh^Fp, Hh, Hh, Hh^Vhh, Hh, Mm, Hh, Mm, Hh, Mm, Mm, Mm, Mm, Mm, Mm, Mm, Gll^Fp
Mm, Hh, Hh^Es, Gs^Fp, Hh, Hh, Gs^Fp, Gs^Fp, Gs^Fp, Wwg, Wwg, Gs, Gs, Re, Re, Gs^Fp, Gs^Es, Re, Gs, Hh, Hh^Fp, Hh^Fp, Hh^Fp, Hh, Hh, Gll^Fp, Hh, Mm, Mm, Mm, Mm, Mm, Mm, Mm, Mm, Mm, Mm, Mm, Mm, Mm
Mm, Mm, Hh, Gs^Fp, Gs, Gs^Fp, Gs, Gs, Gs, Wwg, Wwg, Gs^Efm, Gs^Efm, Gs^Es, Re, Re, Re, Re, Gs, Gs, Gs^Fp, Hh^Fp, Gs, Hh^Fp, Hh^Fp, Hh, Mm, Mm, Mm, Mm, Mm, Mm, Mm, Mm, Mm, Mm, Mm, Mm, Mm, Mm
Gs^Fp, Gs^Fp, Gs^Fms, Gs^Fp, Gs^Fms, Gs, Gs^Efm, Gs^Efm, Gs, Wwg, Wwg, Wwg, Wwg^Bsb/, Re, Mm, Mm, Hh, Re, Re, Gs, Gs, Hh^Fp, Gs, Gs^Em, Hh^Fms, Mm, Mm, Mm, Mm, Mm, Mm, Mm, Mm, Mm, Mm, Mm, Mm, Mm, Mm, Mm
Gs^Fms, Gs^Fms, Gs, Gs^Em, Gs, Gs, Gs, Gs, Gs, Gs, Re, Wwg^Bsb/, Wwg, Hh^Vhh, Mm, Mm, Mm, Hh, Re, Gs, Ce, Gs, Gs^Efm, Gs^Fp, Hh^Fp, Mm, Mm, Mm, Mm, Mm, Mm, Mm, Mm, Mm, Mm, Mm, Mm, Mm, Mm, Mm
Gs^Fms, Gs^Fms, Gs, Gs, Gs, Gs, 7 Ke, Ce, Re, Re, Hh, Wwg, Wwg, Wwg, Mm, Mm, Mm, Mm, Gs, Re, 6 Ke, Ce, Gs, Gs^Fp, Gs^Fp, Hh, Mm, Mm, Mm, Mm, Mm, Mm, Mm, Mm, Mm, Mm, Mm, Mm, Mm, Mm
Gs^Fms, Gs, Gs, Gs^Es, Re, Ce, Ce, Ce, Ce, Hh, Mm, Mm, Wwg, Wwg, Mm, Mm, Mm, Mm, Gs, Ce, Ce, Ce, Gs, Gs, Gs, Gs^Fp, Gs^Fp, Mm, Mm, Hh, Hh^Vhh, Mm, Mm, Mm, Mm, Mm, Mm, Mm, Mm, Mm
Gs, Gs, Re, Re, Gs, Gs, Gs, Gs, Gs, Hh, Mm, Mm, Wwg, Wwg, Wwg, Mm, Gs, Hh, Hh, Gs, Gs, Re, Gs, Gs, Gs, Gs^Fp, Gs^Fp, Hh, Hh, Hh, Hh, Mm, Mm, Mm, Mm, Mm, Mm, Mm, Mm, Mm
