Gg, Gg, Gg, Gg, Re, Re, Re, Gg, Gg, Gg, Gg, Gg, Gg, Gg, Gg^Efm, Gg, Gg, Gg, Gll^Fp, Gg, Gs^Fms, Gg, Gs^Fms, Gg, Gs^Fds, Gs^Fms, Gs^Fms, Gs^Fms, Hh, Gs^Fds, Gs^Fds, Gs^Fms, Gs^Fds, Gll^Fp, Gs^Fms, Gs^Fms, Cv, Cv, Gg^Efm, Gs^Fms, Cv, Cv, Cv, Gs^Fms, Gs^Fms, Gg
Gg, Gg, Gg^Es, Gg, Gg, Re, Re, Re, Re, Gg, Gs, Gs, Gs, Ce, 3 Ke, Gg, Gs^Vh, Gg, Gg, Gg, Gg, Hh, Hh, Gs^Fms, Gs^Fms, Gs^Fds, Hh, Hh, Hh, Gs^Fds, Gs^Fms, Gs^Fds, Gs^Fds, Gs^Fms, Gs^Fms, Gg, Gg^Efm, Gg^Efm, Cv, Cv, Gg^Fet, Gg^Ve, Gg^Fet, Cv, Cv, Gs^Fms
Gg, Gg, Gg, Gg, Gg, Gg, Gg, Re, Re, Re, Re, Re^Vct, Ce, Re^Vct, Re^Vct, Ce, Ce, Gg, Gg, Gg, Gg, Gg^Efm, Gs^Vh, Hh, Hh, Hh, Hh, Gs^Fds, Hh, Gs^Fds, Gs^Fms, Gg^Ve, Gs^Fms, Gs^Fms, Gg, Gg, Cv, Gg^Efm, Cv, Gg^Ve, Cv, Cv, Cv, Gg^Ve, Cv, Gs^Fms
Gg, Gg, Gs^Vl, Gg, Gg, Gg, Gg, Gg^Es, Gs, Re, Re^Vct, Ce, 1 Ke, Ce, Gg, Ce, Gs, Gg, Gg, Gg, Gg, Gg, Gg, Gs^Fds, Hh, Gs^Fms, Gs^Fms, Gs^Fds, Gs^Fms, Gs^Fms, Gs^Fds, Gs^Fms, Gs^Fms, Gs, Gg, Cv, 9 Kv, Gg^Fet, Re^Efm, Gg^Fet, Cv, 7 Kv, Cv, Gg^Fet, Cv, Gs^Fms
Gg, Gll^Fp, Gg, Gg, Gg, Gg, Gg, Gs, Gg, Gs, Gg, Ce, Ce, Ce, Re, Gg, Gg^Es, Gg, Gg, Gg, Gg, Gg, Gg, Gg, Gg, Gll^Fp, Gs^Fms, Hh, Gs^Fms, Gs^Fms, Gs^Fms, Gs^Fms, Gg, Gs, Gg, Cv, Cv, Cv, Re^Efm, Gg^Ve, Gg^Fet, Cv, Gg^Fet, Gg^Ve, Cv, Gs^Fms
Gll^Fp, Gll^Fp, Gs^Fms, Gll^Fp, Gg, Gg, Gg, Gg, Gg, Gg, Ce, Re^Vct, Re^Vct, Re, Re, Re, Re, Gg, Gg, Gg^Efm, Gg, Gg, Gg^Efm, Gg, Gg, Gg, Gs^Fms, Gs^Fms, Gs^Fms, Gs^Fms, Gg, Gs^Fms, Gg, Gg, Re, Gg^Fet, Re, Re^Efm, Cv, Re^Efm, Cv, Gg^Ve, Cv, Cv, Gg^Efm, Gs^Fms
Hh, Gll^Fp, Gll^Fp, Gll^Fp, Gll^Fp, Gs^Fms, Gs^Fms, Gll^Fp, Gs^Vh, Gs, Gg, 2 Ke, Ce, Ce, Gg, Re, Re, Re, Re, Gg, Gg, Gg, Gs^Vl, Gg, Gg, Gll^Fp, Gg, Gs^Fds, Gg, Gg, Gg, Gg, Re, Gg^Ve, Re, Re, Gg^Fet, Cv, 8 Kv, Gg^Fet, Gg^Efm, Cv, Gg^Efm, Gg^Efm, Cv, Cv
Mm, Hh, Hh, Gll^Fp, Gs^Fms, Gll^Fp, Gll^Fp, Gll^Fp, Gs^Fms, Gs^Fms, Gll^Fp, Gll^Fp, Gs^Fms, Ce, Gg, Gg, Gg, Re, Re, Re, Re, Gg, Gg, Gg, Gg, Gg, Gg, Gg, Gg^Es, Gg, Re, Re, Gg, Re, Gs^Fds, Gg, Gg, Cv, Cv, Cv, Gg^Efm, Gg^Efm, Cv, Cv, Gs^Fms, Gs^Fms
Mm, Hh, Hh^Vhh, Hh, Hh, Hh, Hh, Hh, Hh, Hh, Hh, Hh, Hh, Gll^Fp, Gg, Gg, Gg, Gg, Gg^Efm, Re, Re, Re, Re, Gg, Gg, Gg^Efm, Gg, Gg, Re, Gg, Re, Gg, Gg, Gs^Fms, Gs^Fms, Gg, Gs^Fms, Gg, Gg, Gg, Gg, Cv, Gg, Gg, Gs^Fds, Gs^Fds
Mm, Mm, Mm, Mm, Mm, Mm, Mm, Mm, Mm, Hh, Mm, Mm, Hh, Gll^Fp, Gs^Fms, Gll^Fp, Gll^Fp, Gg, Gg, Gg, Gg, Re, Re, Re, Re, Gg, Gs^Fds, Re, Re, Re, Gg, Gg, Gs^Fms, Gg, Gs^Fms, Gg, Gg, Gg, Gs^Fms, Gg, Gg^Efm, Gg, Gg, Gs^Fms, Gs^Fds, Gs^Fds
Mm, Mm, Mm, Mm, Mm, Mm, Mm, Mm, Mm, Mm, Mm, Mm, Hh, Hh, Hh, Hh, Gll^Fp, Gg, Gll^Fp, Gg, Gg, Gg, Gg^Es, Re, Re, Re, Re, Re, Gs^Fds, Gs^Fds, Gg, Gg, Gs^Fms, Gs^Fds, Gs^Fds, Gs^Fms, Gs^Fms, Gs^Fms, Hh, Hh, Hh, Hh, Gs^Fms, Gs^Fds, Gs^Fds, Gs^Fms
Mm, Mm, Mm, Mm, Mm, Mm, Mm, Mm, Mm, Mm, Mm, Mm, Hh, Gs^Fms, Hh, Gs^Fms, Gll^Fp, Gg, Gg, Gs^Vc, Gg, Gg, Gg, Re, Re, Re, Re, Re, Re, Gg, Gg, Gg, Gg, Gs^Fms, Gs^Fds, Gg, Gg, Gs^Fds, Hh, Gs^Fms, Gg^Ve, Gs^Fms, Gg, Gs^Fds, Hh, Gs^Fds
Mm, Mm, Mm, Mm, Mm, Mm, Mm, Mm, Mm, Mm, Hh, Hh, Gll^Fp, Gs^Fms, Hh, Gll^Fp, Gg, Gg^Efm, Gs^Fds, Gs^Fds, Gg, Gg, Re, Re, Rb^Gvs, Rb^Gvs, Rb^Gvs, Re, Re, Re, Re, Gg^Ve, Re, Gs^Fds, Gg, Gg^Efm, Gg, Gs^Fds, Hh, Hh, Gs^Fms, Gs^Fms, Gs^Fds, Gs^Fds, Hh, Gs^Fms
Mm, Mm, Mm, Mm, Mm, Mm, Mm, Mm, Mm, Hh, Gs^Fds, Gs^Fds, Gs^Fds, Gs^Fms, Gll^Fp, Gg, Gll^Fp, Gg, Gg, Gg, Re, Re, Rb^Gvs, Rb^Gvs, Rb^Gvs, Rb^Gvs, Rb^Gvs, Rb^Gvs, Rb^Gvs, Re, Re, Re, Re, Re, Re, Gg, Gs^Fds, Hh, Gg, Hh, Gs^Fms, Gs^Fds, Gs^Fds, Hh, Gs^Fms, Hh
Mm, Mm, Mm, Mm, Mm, Mm, Mm, Mm, Hh, Hh, Hh, Gs^Fds, Gll^Fp, Gll^Fp, Gg, Gg, Gg, Gg, Re, Re, Rb^Gvs, Rb^Gvs, Rb^Gvs, Rb^Gvs, Rb^Gvs, Rb^Gvs, Rb^Gvs, Rb^Gvs, Re, Re, Rb^Gvs, Re, Rb^Gvs, Re, Re, Re, Re, Gs^Fds, Gg, Gg, Gg, Gg, Gs^Fms, Gs^Fds, Gs^Fds, Gs^Fds
Mm, Mm, Mm, Mm, Mm, Mm, Hh^Vhh, Hh, Gs^Fms, Gll^Fp, Gs^Fms, Gll^Fp, Gg, Gg^Efm, Gg, Gg, Re, Re, Re, Rb^Gvs, Rb^Gvs, Rb^Gvs, Rb^Gvs, Rb^Gvs, Rb^Gvs, Rb^Gvs, Re, Re, Rb^Gvs, Rb^Gvs, Rb^Gvs, Rb^Gvs, Rb^Gvs, Rb^Gvs, Rb^Gvs, Re, Re, Re, Re, Gg^Efm, Gs^Fds, Gg, Gg, Gs^Fds, Gs^Fds, Gs^Fms
Mm, Mm, Mm, Mm, Mm, Mm, Mm, Hh, Gs^Fms, Gs^Fms, Gs^Fms, Gll^Fp, Gg, Gg, Re, Re, Rb^Gvs, Re, Re, Re, Re, Rb^Gvs, Rb^Gvs, Rb^Gvs, Re, Re, Rb^Gvs, Rb^Gvs, Rb^Gvs, Rb^Gvs, Rb^Gvs, Rb^Gvs, Rb^Gvs, Rb^Gvs, Rb^Gvs, Rb^Gvs, Rb^Gvs, Re, Re, Re, Re, Gs^Fds, Gg, Gg, Gs^Fms, Gs^Fds
Mm, Mm, Mm, Mm, Mm, Mm, Hh, Hh, Gll^Fp, Gs^Fms, Gs^Fms, Gs^Fms, Re, Re, Rb^Gvs, Rb^Gvs, Rb^Gvs, Rb^Gvs, Rb^Gvs, Re, Re, Re, Re, Re, Rb^Gvs, Gs^Vl, Rb^Gvs, Rb^Gvs, Rb^Gvs, Rb^Gvs, Ww, Rb^Gvs, Ww, Rb^Gvs, Ww, Rb^Gvs, Rb^Gvs, Rb^Gvs, Rb^Gvs, Re, Re, Re, Gg^Efm, Gs^Fms, Gg, Gs^Fms
Mm, Mm, Mm, Mm, Mm, Mm, Hh, Gs^Fds, Gs^Fms, Gs^Fms, Re, Re, Re, Rb^Gvs, Rb^Gvs, Rb^Gvs, Rb^Gvs, Rb^Gvs, Rb^Gvs, Rb^Gvs, Re, Re, Re, Re, Re, Rb^Gvs, Ww, Ww, Ww, Ww, Ww, Ww, Wwf, Ww, Ww, Ww, Ww, Ww, Ww^Bsb/, Re, Re, Re, Gg, Gs^Fms, Ww, Gg
Mm, Mm, Mm, Mm, Mm, Mm, Hh, Gs^Fds, Gs^Fds, Gll^Fp, Rb^Gvs, Rb^Gvs, Rb^Gvs, Re, Re, Rb^Gvs, Gs^Vl, Rb^Gvs, Re, Re, Rb^Gvs, Rb^Gvs, Rb^Gvs, Re, Ww^Bsb\, Ww^Bsb\, Ww^Bsb\, Ww, Ch, Wwr, Ch, Ch, Ch, Ch, Ch, Ch, Rrc, Ww^Bsb/, Ww^Bsb/, Ww^Bsb/, Ww, Ww, Ww, Ww, Ww, Ww
Mm, Mm, Mm, Mm, Mm, Mm, Hh, Gll^Fp, Hh, Gs^Fds, Gll^Fp, Gll^Fp, Rb^Gvs, Rb^Gvs, Gs^Vl, Re, Re, Re, Rb^Gvs, Rb^Gvs, Rb^Gvs, Rb^Gvs, Ww, Ww, Ww, Ww^Bsb\, Rrc, Rrc, Rrc, Ch, Gg^Efm, Gg^Efm, Gg^Efm, Gg^Efm, Rrc, Rrc, Rrc, Rrc, Ch, Ww, Ww, Ww, Ww, Ww, Ww, Ww
Mm, Mm, Mm, Mm, Mm, Mm, Mm, Hh, Hh, Gs^Fds, Hh, Gs^Fms, Gs^Fms, Rb^Gvs, Re, Re, Rb^Gvs, Rb^Gvs, Rb^Gvs, Rb^Gvs, Gll^Fp, Ww, Ww, Ww, Ch, Ch, Ch, Rrc, Rrc, Rrc, Rrc, Re, Rrc, Rrc, Rrc, Rrc, Ch, Ch, Wwr, Ww, Ww, Ww, Wo, Ww, Wo, Ww
Mm, Mm, Mm, Mm, Mm, Mm, Mm, Mm, Mm, Hh, Hh, Gll^Fp, Gll^Fp, Re, Rb^Gvs, Rb^Gvs, Gll^Fp, Gll^Fp, Gll^Fp, Gll^Fp, Gll^Fp, Ww, Ww, Ww, Ch, 6 Kh, Gg^Efm, Gg^Efm, Rr^Vhc, Rrc, Rrc, Rrc, Rrc, Rrc, Rr^Vhc, Gg^Efm, Ch, 5 Kh, Ww, Ww, Ww, Wo, Wo, Wo, Wo, Wo
Mm, Mm, Mm, Mm, Mm, Mm, Mm, Hh, Mm, Gs^Fms, Hh, Gll^Fp, Gs^Fds, Gs^Fms, Gll^Fp, Rb^Gvs, Gs^Fds, Gll^Fp, Hh, Hh, Hh, Wwr, Ww, Ww, Wwf, Gg^Efm, Gg^Efm, Re, Re, Rr^Vhc, Rr^Vhc, Rrc, Rrc, Rrc, Rrc, Rr^Vhc, Rrc, Ch, Ww, Ww, Wo, Wo, Wo, Wo, Wo, Wo
Mm, Mm, Mm, Mm, Mm, Mm, Mm, Mm, Mm, Hh, Hh, Hh, Hh, Gs^Fds, Gs^Fds, Gs^Fms, Gs^Fds, Hh, Mm, Mm, Mm, Mm, Mm, Ww, Wwf, Ch, Ch, Gg^Efm, Gg^Efm, Re, Re, Rr^Vhc, Rrc, Rrc, Rrc, Rrc, Ww^Bw\, Ww^Bw\, Ww, Ww, Wo, Wo, Wo, Wo, Wo, Wo
Mm, Mm, Mm, Mm, Mm, Mm, Mm, Mm, Mm, Mm, Mm, Hh, Hh, Hh, Gs^Fds, Gs^Fds, Hh, Hh, Mm, Mm, Mm, Mm, Mm, Wwf, Ww, Wwf, Ww, Ch, Ch, Gg^Efm, Rrc, Rrc, Rr^Vhc, Rr^Vhc, Ww, Ww^Bw\, Ww, Ww, Ww, Ww, Wo, Wo, Wo, Wo, Wo, Wo
Mm, Mm, Mm, Mm, Mm, Mm, Mm, Mm, Mm, Mm, Mm, Mm, Mm, Hh, Hh^Vhh, Hh, Mm, Mm, Mm, Mm, Mm, Mm, Mm, Mm, Wwr, Ww, Ww, Ww, Wwf, Ch, Ch, Rrc, Ww^Bsb\, Ww, Ch, Ww, Ww, Ww, Wo, Wo, Wo, Wo, Wo, Wo, Wo, Wo
Mm, Mm, Mm, Mm, Mm, Mm, Mm, Mm, Mm, Mm, Mm, Mm, Mm, Mm, Mm, Mm, Mm, Mm, Mm, Mm, Mm, Mm, Mm, Mm, Mm, Ww, Ww, Ww, Ww, Ww, Ww, Ww, Ch, Rrc, 4 Kh, Ch, Ch, Ww, Wo, Wo, Wo, Wo, Wo, Wo, Wo, Wo
Mm, Mm, Mm, Mm, Mm, Mm, Mm, Mm, Mm, Mm, Mm, Mm, Mm, Mm, Mm, Mm, Mm, Mm, Mm, Mm, Mm, Mm, Mm, Mm, Mm, Wwf, Ww, Ww, Wo, Ww, Ww, Ww, Ww, Ch, Ch, Ch, Ww, Ww, Wo, Wo, Wo, Wo, Wo, Wo, Wo, Wo
Mm, Mm, Mm, Mm, Mm, Mm, Mm, Mm, Mm, Mm, Mm, Mm, Mm, Mm, Mm, Mm, Mm, Mm, Mm, Mm, Mm, Mm, Mm, Mm, Mm, Ww, Ww, Wo, Wo, Wo, Ww, Ww, Ww, Ww, Ww, Ww, Ww, Wo, Wo, Wo, Wo, Wo, Wo, Wo, Wo, Wo
Mm, Mm, Mm, Mm, Mm, Mm, Mm, Mm, Mm, Mm, Mm, Mm, Mm, Mm, Mm, Mm, Mm, Mm, Mm, Mm, Mm, Mm, Mm, Mm, Wwf, Ww, Ww, Wo, Wo, Wo, Wo, Ww, Ww, Ww, Wo, Wo, Wo, Wo, Wo, Wo, Wo, Wo, Wo, Wo, Wo, Wo
Mm, Mm, Mm, Mm, Mm, Mm, Mm, Mm, Mm, Mm, Mm, Mm, Mm, Mm, Mm, Mm, Mm, Mm, Mm, Mm, Mm, Mm, Mm, Mm, Ww, Ww, Wo, Wo, Wo, Wo, Wo, Wo, Wo, Wo, Wo, Wo, Wo, Wo, Wo, Wo, Wo, Wo, Wo, Wo, Wo, Wo
Mm, Mm, Mm, Mm, Mm, Mm, Mm, Mm, Mm, Mm, Mm, Mm, Mm, Mm, Mm, Mm, Mm, Mm, Mm, Mm, Mm, Mm, Wwf, Ww, Ww, Ww, Wo, Wo, Wo, Wo, Wo, Wo, Wo, Wo, Wo, Wo, Wo, Wo, Wo, Wo, Wo, Wo, Wo, Wo, Wo, Wo
Mm, Mm, Mm, Mm, Mm, Mm, Mm, Mm, Mm, Mm, Mm, Mm, Mm, Mm, Mm, Mm, Mm, Mm, Mm, Mm, Mm, Mm, Wwf, Ww, Ww, Wo, Wo, Wo, Wo, Wo, Wo, Wo, Wo, Wo, Wo, Wo, Wo, Wo, Wo, Wo, Wo, Wo, Wo, Wo, Wo, Wo
Mm, Mm, Mm, Mm, Mm, Mm, Mm, Mm, Mm, Mm, Mm, Mm, Mm, Mm, Mm, Mm, Mm, Mm, Mm, Mm, Mm, Mm, Mm, Mm, Hh, Ww, Ww, Wo, Wo, Wo, Wo, Wo, Wo, Wo, Wo, Wo, Wo, Wo, Wo, Wo, Wo, Wo, Wo, Wo, Wo, Wo
