Gg, Gg, Gg, Gg, Re, Re, Re, Gg, Gg, Gg, Gg, Gg, Gg, Gg, Gg^Efm, Gg, Gg, Gg, Gll^Fp, Hh, Hh, Gg, Mm, Mm, Mm, Mm, Mm, Mm, Mm, Mm, Mm, Mm, Hh, Mm, Mm, Mm, Mm, Mm, Mm, Mm, Mm, Mm, Mm, Mm, Mm, Mm
Gg, Gg, Gg^Es, Gg, Gg, Re, Re, Re, Re, Gg, Gs, Gs, Gs, Gs, Gs, Gg, Gs^Vh, Gg, Gg, Gll^Fp, Gll^Fp, Hh, Hh, Hh, Hh, Mm, Mm, Mm, Mm, Mm, Hh, Hh, Gs^Fds, Hh, Hh, Mm, Mm, Mm, Mm, Mm, Mm, Mm, Mm, Mm, Mm, Mm
Gg, Gg, Gg, Gg, Gg, Gg, Gg, Re, Re, Re, Re, Gg, Ce, Ce, Ce, Gs, Gs, Gg, Gg, Gll^Fp, Gg, Gll^Fp, Gs^Vh, Hh, Hh, Hh, Mm, Mm, Mm, Hh, Gll^Fp, Gs^Vl, Gll^Fp, Gll^Fp, Gll^Fp, Hh, Hh, Hh, Ch, Mm, Mm, Mm, Ch, Mm, Mm, Mm
Gg, Gg, Gs^Vl, Gg, Gg, Gg, Gg, Gg^Es, Gs, Re, Re, Re, Re, 1 Ke, Ce, Gs, Gs, Gg, Gg, Gg, Gg, Gg, Gg, Gll^Fp, Hh, Hh, Hh, Mm, Hh, Hh, Gs^Fds, Gs^Fms, Gs^Fms, Gll^Fp, Gg, Gll^Fp, Gs, Ch, Hh, Hh, Ch, Hh, Hh, Ch, Mm, Mm
Gg, Gll^Fp, Gg, Gg, Gg, Gg, Gg, Gs, Gs, Gs, Ce, Re, Re, Re, Re, Gs, Gg^Es, Gg, Gg, Gg, Gg, Gg, Gg, Gll^Fp, Gll^Fp, Gll^Fp, Hh, Hh, Hh, Gll^Fp, Gs^Fms, Gs^Fms, Gg, Gs, Gg, Gg, Gs, Ch, Re, Ch, 6 Kh, Ch, Hh, Ch, Mm, Mm
Gll^Fp, Gll^Fp, Gs^Fms, Gll^Fp, Gg, Gg, Gg, Gg, Gg, Gs, Ce, 2 Ke, Ce, Re, Re, Re, Re, Gg, Gg, Gg^Efm, Gg, Gg, Gg^Efm, Gg, Gg, Gll^Fp, Gs^Fms, Hh, Gs^Fms, Gs^Fms, Gs^Vh, Gs^Fms, Gg, Gg, Gg, Gg, Re, Re, Re, Ch, Ch, Ch, Hh, Mm, Mm, Mm
Hh, Gll^Fp, Gll^Fp, Gll^Fp, Gll^Fp, Gs^Fms, Gs^Fms, Gll^Fp, Gs^Vh, Gs, Gg, Ce, Gs, Gs, Gg, Re, Re, Re, Re, Gg, Gg, Gg, Gs^Vl, Gg, Gg, Gll^Fp, Gg, Gs^Fds, Gg, Gg, Gg, Gg, Gg, Gg, Re, Re, Re, Re, Re, Re, Re, Hh, Hh, Mm, Mm, Mm
Mm, Hh, Hh, Gll^Fp, Gs^Fms, Gll^Fp, Gll^Fp, Gll^Fp, Gs^Fms, Gs^Fms, Gll^Fp, Gll^Fp, Gs^Fms, Gs, Gg, Gg, Gg, Re, Re, Re, Re, Gg, Gg, Gg, Gg, Gg, Gg, Gg, Gg^Es, Gg, Gg, Gg, Re, Re, Re, Re, Gg, Gs^Vh, Gg, Ch, Ch, Ch, Hh, Mm, Mm, Mm
Mm, Hh, Hh^Vhh, Hh, Hh, Hh, Hh, Hh, Hh, Hh, Hh, Hh, Hh, Gll^Fp, Gg, Gg, Gg, Gg, Gg^Efm, Re, Re, Re, Re, Gg, Gg, Gg^Efm, Gg, Gg, Gg, Gg, Re, Re, Re, Re, Gg, Gg, Gg, Gg, Gg, Gs, Gs, Gll^Fp, Hh, Hh, Mm, Mm
Mm, Mm, Mm, Mm, Mm, Mm, Mm, Mm, Mm, Hh, Mm, Mm, Hh, Gll^Fp, Gs^Fms, Gll^Fp, Gll^Fp, Gg, Gg, Gg, Gg, Re, Re, Re, Re, Gg, Gs, Gg, Re, Re, Re, Re, Gg, Gg, Gg, Gg, Gg, Gg, Gs^Fms, Gg, Gll^Fp, Gll^Fp, Gll^Fp, Hh, Mm, Mm
Mm, Mm, Mm, Mm, Mm, Mm, Mm, Mm, Mm, Mm, Mm, Mm, Hh, Hh, Hh, Hh, Gll^Fp, Gg, Gll^Fp, Gg, Gg, Gg, Gg^Es, Re, Re, Re, Re, Re, Re, Re, Gg, Gg, Gs, Gg, Gs, Gs^Fms, Gs^Fms, Gs^Fms, Hh, Hh, Hh, Hh, Hh, Hh, Mm, Mm
Mm, Mm, Mm, Mm, Mm, Mm, Mm, Mm, Mm, Mm, Mm, Mm, Hh, Gs^Fms, Hh, Gs^Fms, Gll^Fp, Gg, Gg, Gs^Vc, Gg, Gg, Gg, Re, Re, Re, Re, Re, Re, Gg, Gg, Gg, Gg, Gs, Gs^Fds, Gg, Gg, Gs^Fds, Hh, Gs^Fms, Gs^Vh, Hh, Mm, Mm, Mm, Mm
Mm, Mm, Mm, Mm, Mm, Mm, Mm, Mm, Mm, Mm, Hh, Hh, Gll^Fp, Gs^Fms, Hh, Gll^Fp, Gg, Gg^Efm, Gs^Fds, Gs^Fds, Gg, Gg, Re, Re, Rb^Gvs, Rb^Gvs, Rb^Gvs, Re, Re, Re, Re, Gs^Vh, Re, Gs^Fds, Gg, Gg^Efm, Gg, Gs^Fds, Hh, Hh, Hh, Mm, Mm, Mm, Mm, Mm
Mm, Mm, Mm, Mm, Mm, Mm, Mm, Mm, Mm, Hh, Gs^Fds, Gs^Fds, Gs^Fds, Gs^Fms, Gll^Fp, Gg, Gll^Fp, Gg, Gg, Gg, Re, Re, Rb^Gvs, Rb^Gvs, Rb^Gvs, Rb^Gvs, Rb^Gvs, Rb^Gvs, Rb^Gvs, Re, Re, Re, Re, Re, Re, Gg, Gs, Hh, Gll^Fp, Hh, Hh, Hh, Mm, Mm, Mm, Mm
Mm, Mm, Mm, Mm, Mm, Mm, Mm, Mm, Hh, Hh, Hh, Gs^Fds, Gll^Fp, Gll^Fp, Gg, Gg, Gg, Gg, Re, Re, Rb^Gvs, Rb^Gvs, Rb^Gvs, Rb^Gvs, Rb^Gvs, Rb^Gvs, Rb^Gvs, Rb^Gvs, Re, Re, Rb^Gvs, Re, Rb^Gvs, Re, Re, Re, Re, Gs, Gg, Gll^Fp, Gll^Fp, Hh, Hh, Mm, Mm, Mm
Mm, Mm, Mm, Mm, Mm, Mm, Hh^Vhh, Hh, Gs^Fms, Gll^Fp, Gs^Fms, Gll^Fp, Gg, Gg^Efm, Gg, Gg, Re, Re, Re, Rb^Gvs, Rb^Gvs, Rb^Gvs, Rb^Gvs, Rb^Gvs, Rb^Gvs, Rb^Gvs, Re, Re, Rb^Gvs, Rb^Gvs, Rb^Gvs, Rb^Gvs, Rb^Gvs, Rb^Gvs, Rb^Gvs, Re, Re, Re, Re, Gg^Efm, Gs, Gll^Fp, Gll^Fp, Hh, Hh, Mm
Mm, Mm, Mm, Mm, Mm, Mm, Mm, Hh, Gs^Fms, Gs^Fms, Gs^Fms, Gll^Fp, Gg, Gg, Re, Re, Rb^Gvs, Re, Re, Re, Re, Rb^Gvs, Rb^Gvs, Rb^Gvs, Re, Re, Rb^Gvs, Rb^Gvs, Rb^Gvs, Rb^Gvs, Rb^Gvs, Rb^Gvs, Rb^Gvs, Rb^Gvs, Rb^Gvs, Rb^Gvs, Rb^Gvs, Re, Re, Re, Re, Gll^Fp, Gll^Fp, Hh, Hh, Mm
Mm, Mm, Mm, Mm, Mm, Mm, Hh, Hh, Gll^Fp, Gs^Fms, Gs^Fms, Gs^Fms, Re, Re, Rb^Gvs, Rb^Gvs, Rb^Gvs, Rb^Gvs, Rb^Gvs, Re, Re, Re, Re, Re, Rb^Gvs, Gs^Vl, Rb^Gvs, Rb^Gvs, Rb^Gvs, Rb^Gvs, Ww, Rb^Gvs, Ww, Rb^Gvs, Ww, Rb^Gvs, Rb^Gvs, Rb^Gvs, Rb^Gvs, Re, Re, Re, Gg^Efm, Gs^Fms, Hh, Hh
Mm, Mm, Mm, Mm, Mm, Mm, Hh, Gs^Fds, Gs^Fms, Gs^Fms, Re, Re, Re, Rb^Gvs, Rb^Gvs, Rb^Gvs, Rb^Gvs, Rb^Gvs, Rb^Gvs, Rb^Gvs, Re, Re, Re, Re, Re, Rb^Gvs, Ww, Ww, Ww, Ww, Ww, Ww, Wwf, Ww, Ww, Ww, Ww, Ww, Ww^Bsb/, Re, Re, Re, Gg, Gs^Fms, Ww, Hh
Mm, Mm, Mm, Mm, Mm, Mm, Hh, Gs^Fds, Gs^Fds, Gll^Fp, Rb^Gvs, Rb^Gvs, Rb^Gvs, Re, Re, Rb^Gvs, Gs^Vl, Rb^Gvs, Re, Re, Rb^Gvs, Rb^Gvs, Rb^Gvs, Re, Ww^Bsb\, Ww^Bsb\, Ww^Bsb\, Ww, Ch, Wwr, Ch, Ch, Ch, Ch, Ch, Ch, Rrc, Ww^Bsb/, Ww^Bsb/, Ww^Bsb/, Ww, Ww, Ww, Ww, Ww, Ww
Mm, Mm, Mm, Mm, Mm, Mm, Hh, Gll^Fp, Hh, Gs^Fds, Gll^Fp, Gll^Fp, Rb^Gvs, Rb^Gvs, Gs^Vl, Re, Re, Re, Rb^Gvs, Rb^Gvs, Rb^Gvs, Rb^Gvs, Ww, Ww, Ww, Ww^Bsb\, Rrc, Rrc, Rrc, Ch, Gg^Efm, Gg^Efm, Gg^Efm, Gg^Efm, Rrc, Rrc, Rrc, Rrc, Ch, Ww, Ww, Ww, Ww, Ww, Ww, Ww
Mm, Mm, Mm, Mm, Mm, Mm, Mm, Hh, Hh, Gs^Fds, Hh, Gs^Fms, Gs^Fms, Rb^Gvs, Re, Re, Rb^Gvs, Rb^Gvs, Rb^Gvs, Rb^Gvs, Gll^Fp, Ww, Ww, Ww, Ch, Ch, Ch, Rrc, Rrc, Rrc, Rrc, Re, Rrc, Rrc, Rrc, Rrc, Ch, Ch, Wwr, Ww, Ww, Ww, Wo, Ww, Wo, Ww
Mm, Mm, Mm, Mm, Mm, Mm, Mm, Mm, Mm, Hh, Hh, Gll^Fp, Gll^Fp, Re, Rb^Gvs, Rb^Gvs, Gll^Fp, Gll^Fp, Gll^Fp, Gll^Fp, Gll^Fp, Ww, Ww, Ww, Ch, 5 Kh, Gg^Efm, Gg^Efm, Rr^Vhc, Rrc, Rrc, Rrc, Rrc, Rrc, Rr^Vhc, Gg^Efm, Ch, 4 Kh, Ww, Ww, Ww, Wo, Wo, Wo, Wo, Wo
Mm, Mm, Mm, Mm, Mm, Mm, Mm, Hh, Mm, Gs^Fms, Hh, Gll^Fp, Gs^Fds, Gs^Fms, Gll^Fp, Rb^Gvs, Gs^Fds, Gll^Fp, Hh, Hh, Hh, Wwr, Ww, Ww, Wwf, Gg^Efm, Gg^Efm, Re, Re, Rr^Vhc, Rr^Vhc, Rrc, Rrc, Rrc, Rrc, Rr^Vhc, Rrc, Ch, Ww, Ww, Wo, Wo, Wo, Wo, Wo, Wo
Mm, Mm, Mm, Mm, Mm, Mm, Mm, Mm, Mm, Hh, Hh, Hh, Hh, Gs^Fds, Gs^Fds, Gs^Fms, Gs^Fds, Hh, Mm, Mm, Mm, Mm, Mm, Ww, Wwf, Ch, Ch, Gg^Efm, Gg^Efm, Re, Re, Rr^Vhc, Rrc, Rrc, Rrc, Rrc, Ww^Bw\, Ww^Bw\, Ww, Ww, Wo, Wo, Wo, Wo, Wo, Wo
Mm, Mm, Mm, Mm, Mm, Mm, Mm, Mm, Mm, Mm, Mm, Hh, Hh, Hh, Gs^Fds, Gs^Fds, Hh, Hh, Mm, Mm, Mm, Mm, Mm, Wwf, Ww, Wwf, Ww, Ch, Ch, Gg^Efm, Rrc, Rrc, Rr^Vhc, Rr^Vhc, Ww, Ww^Bw\, Ww, Ww, Ww, Ww, Wo, Wo, Wo, Wo, Wo, Wo
Mm, Mm, Mm, Mm, Mm, Mm, Mm, Mm, Mm, Mm, Mm, Mm, Mm, Hh, Hh^Vhh, Hh, Mm, Mm, Mm, Mm, Mm, Mm, Mm, Mm, Wwr, Ww, Ww, Ww, Wwf, Ch, Ch, Rrc, Ww^Bsb\, Ww, Ch, Ww, Ww, Ww, Wo, Wo, Wo, Wo, Wo, Wo, Wo, Wo
Mm, Mm, Mm, Mm, Mm, Mm, Mm, Mm, Mm, Mm, Mm, Mm, Mm, Mm, Mm, Mm, Mm, Mm, Mm, Mm, Mm, Mm, Mm, Mm, Mm, Ww, Ww, Ww, Ww, Ww, Ww, Ww, Ch, Rrc, 3 Kh, Ch, Ch, Ww, Wo, Wo, Wo, Wo, Wo, Wo, Wo, Wo
Mm, Mm, Mm, Mm, Mm, Mm, Mm, Mm, Mm, Mm, Mm, Mm, Mm, Mm, Mm, Mm, Mm, Mm, Mm, Mm, Mm, Mm, Mm, Mm, Mm, Wwf, Ww, Ww, Wo, Ww, Ww, Ww, Ww, Ch, Ch, Ch, Ww, Ww, Wo, Wo, Wo, Wo, Wo, Wo, Wo, Wo
Mm, Mm, Mm, Mm, Mm, Mm, Mm, Mm, Mm, Mm, Mm, Mm, Mm, Mm, Mm, Mm, Mm, Mm, Mm, Mm, Mm, Mm, Mm, Mm, Mm, Ww, Ww, Wo, Wo, Wo, Ww, Ww, Ww, Ww, Ww, Ww, Ww, Wo, Wo, Wo, Wo, Wo, Wo, Wo, Wo, Wo
Mm, Mm, Mm, Mm, Mm, Mm, Mm, Mm, Mm, Mm, Mm, Mm, Mm, Mm, Mm, Mm, Mm, Mm, Mm, Mm, Mm, Mm, Mm, Mm, Wwf, Ww, Ww, Wo, Wo, Wo, Wo, Ww, Ww, Ww, Wo, Wo, Wo, Wo, Wo, Wo, Wo, Wo, Wo, Wo, Wo, Wo
Mm, Mm, Mm, Mm, Mm, Mm, Mm, Mm, Mm, Mm, Mm, Mm, Mm, Mm, Mm, Mm, Mm, Mm, Mm, Mm, Mm, Mm, Mm, Mm, Ww, Ww, Wo, Wo, Wo, Wo, Wo, Wo, Wo, Wo, Wo, Wo, Wo, Wo, Wo, Wo, Wo, Wo, Wo, Wo, Wo, Wo
Mm, Mm, Mm, Mm, Mm, Mm, Mm, Mm, Mm, Mm, Mm, Mm, Mm, Mm, Mm, Mm, Mm, Mm, Mm, Mm, Mm, Mm, Wwf, Ww, Ww, Ww, Wo, Wo, Wo, Wo, Wo, Wo, Wo, Wo, Wo, Wo, Wo, Wo, Wo, Wo, Wo, Wo, Wo, Wo, Wo, Wo
Mm, Mm, Mm, Mm, Mm, Mm, Mm, Mm, Mm, Mm, Mm, Mm, Mm, Mm, Mm, Mm, Mm, Mm, Mm, Mm, Mm, Mm, Wwf, Ww, Ww, Wo, Wo, Wo, Wo, Wo, Wo, Wo, Wo, Wo, Wo, Wo, Wo, Wo, Wo, Wo, Wo, Wo, Wo, Wo, Wo, Wo
Mm, Mm, Mm, Mm, Mm, Mm, Mm, Mm, Mm, Mm, Mm, Mm, Mm, Mm, Mm, Mm, Mm, Mm, Mm, Mm, Mm, Mm, Mm, Mm, Hh, Ww, Ww, Wo, Wo, Wo, Wo, Wo, Wo, Wo, Wo, Wo, Wo, Wo, Wo, Wo, Wo, Wo, Wo, Wo, Wo, Wo
