Gs, Gs, Gs, Gs, Gg, Gg, Gg, Gs, Gs, Gs, Gs, Gs, Gll^Fp, Gll^Fp, Gll^Fp, Gll^Fp, Gll^Fp, Gll^Fp, Gg, Ww, Ww, Ww, Ww, Ww, Gll^Fp, Gll^Fp, Gs, Gs, Gs, Gs, Gs, Gs, Hh, Hh, Mm, Mm, Mm, Mm, Re, Re
Gs, Gs, Gs, Gs, Gg, Gg, Gg, Gg, Gg, Gs, Gs, Gs, Gll^Fp, Gll^Fp, Gll^Fp, Gll^Fp, Gll^Fp, Gll^Fp, Gg, Ww, Ww, Ww, Ww, Ww, Gd^Vo, Gll^Fp, Gs, Gs, Gs, Gs, Gs, Gs, Hh, Hh, Mm, Mm, Re, Re, Hh, Mm
Gs, Gs, Gs, Gs, Gs, Gg, Gg, Gg, Gg, Gg, Gg, Gs, Gll^Fp, Gll^Fp, Gll^Fp, Gll^Fp, Gll^Fp, Gll^Fp, Gll^Fp, Gg, Ww, Ww, Ww, Gll^Fp, Gll^Fp, Gll^Fp, Gs, Gs, Gs, Gs, Gs, Gs, Gs, Hh, Re, Re, Hh, Hh, Hh, Hh
Gs, Gs, Gs, Gs, Gs, Gs, Gs, Gg, Gg, Gg, Gg, Gs, Gs, Gll^Fp, Gll^Fp, Gll^Fp, Gll^Fp, Gll^Fp, Gs, Gg, Gg, Ww, Ww, Gll^Fp, Gg, Gg, Gs, Gs, Gs, Gs, Gll^Fp, Gs, Gs, Gs, Re, Hh, Hh, Hh, Hh, Hh
Rr, Rr, Rr, Rr, Rr, Gs, Gs, Gs, Gg, Gg, Gd^Vo, Gs, Gs, Gll^Fp, Gll^Fp, Gll^Fp, Gs, Gll^Fp, Gll^Fp, Gg, Gg, Wwf, Wwf, Gg, Gg, Gs, Gs, Gll^Fp, Gg, Gll^Fp, Gs, Gs, Gs, Gs, Re, Hh, Gs, Hh, Mm, Mm
Gs, Gs, Gs, Gs, Gs, Rr, Gs, Gs, Gs, Gs, Gs, Gs, Gs, Gs, Gs, Gs, Gs, Gg, Gg, Gg, Re^Gvs, Wwf, Wwf, Gg, Gs, Gll^Fp, Gll^Fp, Gll^Fp, Gll^Fp, Gll^Fp, Gs, Gs, Gs, Re, Gs, Gs, Gs, Hh, Hh^Vo, Mm
Gs, Gs, Gg, Gs, Gs, Rr, Rr, Gs, Gs, Gs, Gll^Fp, Gs, Gll^Fp, Gs, Gs, Gs, Re^Gvs, Gg, Re^Gvs, Re^Gvs, Re^Gvs, Ww, Ww, Gg, Gg, Gll^Fp, Gll^Fp, Gg, Gll^Fp, Gs, Gll^Fp, Gs, Gs, Re, Gs, Gs, Hh, Mm, Mm, Mm
Gs, Gs, Gs, Gg, Gs, Gg^Vo, Rr, Gs, Gs, Gs, Gs, Gll^Fp, Gll^Fp, Gll^Fp, Gll^Fp, Gll^Fp, Gg, Re^Gvs, Re^Gvs, Re^Gvs, Gg, Ww, Ww, Gg, Gg, Gs, Gs, Gll^Fp, Gll^Fp, Gd^Vo, Gs, Gs, Re, Re, Gs, Gs, Gs, Hh, Hh, Hh
Gs, Gs, Gs, Gg, Gs, Gs, Rr, Re^Gvs, Re^Gvs, Re^Gvs, Gs, Gs, Gs, Gs, Gs, Gs, Re^Gvs, Gg, Gg, Gg, Re^Gvs, Ww, Rb^Gvs, Rb^Gvs, Rb^Gvs, Gg, Gs, Gs, Gs, Gll^Fp, Re, Re, Gs, Gs, Gs, Gs, Gs, Hh, Hh, Hh
Gll^Fp, Gll^Fp, Gll^Fp, Gg, Gs, Gs, Re^Gvs, Rr, Re^Gvs, Re^Gvs, Rr, Re^Gvs, Re^Gvs, Re^Gvs, Gs, Gs, Re^Gvs, Re^Gvs, Re^Gvs, Re^Gvs, Re^Gvs, Ww, Ww, Rb^Gvs, Rb^Gvs, Rb^Gvs, Rb^Gvs, Re^Gvs, Rb, Re, Gs, Gs, Gs, Gs, Gg, Gg, Gs, Hh, Hh, Hh
Gll^Fp, Gll^Fp, Gs, Gs, Re^Gvs, Gs, Gs, Rr, Rr, Rr, Gll^Fp, Rr, Re^Vo, Re^Gvs, Rr, Gg, Rr, Re^Gvs, Re^Gvs, Re^Gvs, Ww, Ww, Ss, Ww, Rb^Gvs, Rb^Gvs, Rb, Rb, Rb^Gvs, Hh, Hh, Gs, Gs, Gg, Gg, Gg, Hh^Vo, Gs, Hh, Hh
Gll^Fp, Gll^Fp, Gll^Fp, Gs, Re^Gvs, Re^Gvs, Re^Gvs, Gs, Gll^Fp, Gll^Fp, Gll^Fp, Rr, Rr, Rr, Gg, Rr, Gg, Rr, Rr, Ww, Ss, Ss, Co, Ww, Wwf, Rb, Rb^Gvs, Rb^Gvs, Rb^Gvs, Hh, Gs, Hh, Gg, Gg, Re^Gvs, Hh, Hh, Hh, Hh, Hh
Gll^Fp, Gll^Fp, Gg, Re^Gvs, Re, Re^Gvs, Re^Gvs, Gs, Re, Gll^Fp, Gg, Re^Gvs, Re^Gvs, Re^Gvs, Gg, Gg, Re^Gvs, Re^Gvs, Re^Gvs, Ww^Bw\, Rb, Co, Co, Co, Wwf, Rb^Gvs, Rb^Gvs, Rb^Gvs, Gg, Gg, Gg, Gg, Rb^Gvs, Gg, Rb^Gvs, Hh, Hh, Hh, Hh, Hh
Re, Re, Re, Re, Re, Re, Re, Re, Re^Gvs, Re, Re, Gg, Gg, Gg, Re^Gvs, Re^Gvs, Re^Gvs, Re^Gvs, Ww, Ww, Hh^Vo, Co, Hh, Co, Ww, Rb^Gvs, Rb^Gvs, Rb^Gvs, Rb^Gvs, Rb^Gvs, Rb^Gvs, Rb^Gvs, Rb^Gvs, Rb^Gvs, Re, Hh, Gg, Hh, Hh, Hh
Re, Re, Re, Re, Re^Gvs, Re^Gvs, Gll^Fp, Re^Gvs, Gll^Fp, Gll^Fp, Re, Re, Re, Re^Gvs, Re^Gvs, Re^Gvs, Ww, Ww, Co, Co, Co, Co, Hh, 2 Ko, Co, Ww, Ww, Rb^Gvs, Ww, Rb^Gvs, Rb^Gvs, Rb^Gvs, Re, Re, Re^Gvs, Re^Gvs, Re^Gvs, Gg, Hh, Hh
Gll^Fp, Gll^Fp, Gll^Fp, Re^Gvs, Gg, Gg, Gll^Fp, Gll^Fp, Re, Re, Re, Gg, Re^Gvs, Re, Re, Wwf, Wwf, Rb, Co, Co, Co, Hh^Vo, Hh^Vo, Hh, Co, Co, Hh^Vo, Ww, Rb^Gvs, Ww, Ww, Rb^Gvs, Wwf, Re^Gvs, Re^Gvs, Re^Gvs, Gg, Gg, Hh, Hh
Gll^Fp, Gll^Fp, Gll^Fp, Gll^Fp, Gg, Gg, Re, Re, Gs, Gs, Gs, Gll^Fp, Gll^Fp, Re^Gvs, Re, Wwf, Ww, Hh, Hh, Ko, Co, Hh, Co, Co, Co, Co, Hh, Rb^Gvs, Rb^Gvs, Rb^Gvs, Rb, Wwf, Re, Ww, Ww, Gg, Hh, Hh, Wo, Wo
Gll^Fp, Gll^Fp, Gg, Gg, Re, Re, Gs, Gs, Gll^Fp, Gs, Gll^Fp, Gll^Fp, Gll^Fp, Re^Gvs, Re, Ww, Ww, Ss, Hh, Rb^Gvs, Hh, Co, Hh, Co, Rb, Hh, Hh, Rb^Gvs, Rb, Rb, Rb^Gvs, Gg^Vo, Rb^Gvs, Rb^Gvs, Rb^Gvs, Ww, Wo, Wo, Rb, Rb
Gll^Fp, Gll^Fp, Gg, Re, Gs, Gs, Gll^Fp, Gll^Fp, Gll^Fp, Gll^Fp, Gll^Fp, Gll^Fp, Gg, Re^Gvs, Re, Ss, Ww, Ss, Ss, Rb^Gvs, Rb^Gvs, Rb^Gvs, Rb^Gvs, Rb^Gvs, Rb^Gvs, Rb, Rb, Rb, Rb^Gvs, Rb^Gvs, Rb^Gvs, Rb^Gvs, Rb, Rb^Gvs, Rb^Gvs, Rb^Gvs, Rb, Rb, Gg, Gg
Gg, Gg, Gg, Re, Gs, Gll^Fp, Gll^Fp, Gll^Fp, Gs, Gll^Fp, Gll^Fp, Gll^Fp, Re, Re, Ww, Ww, Gll^Fp, Ww, Ss, Rb^Gvs, Gll^Fp, Rb^Gvs, Rb^Gvs, Rb^Gvs, Rb^Gvs, Rb^Gvs, Rb^Gvs, 1 Rb, Rb, Rb^Gvs, Rb, Rb, Rb^Gvs, Rb, Rb, Rb, Gg, Gg, Hh, Hh
Gll^Fp, Gll^Fp, Gg, Re, Re, Gs, Gs, Gg^Vo, Gs, Gs, Gg, Gg, Re, Gg, Ww, Gll^Fp, Gll^Fp, Ww, Ss, Gg, Gll^Fp, Rb^Gvs, Gll^Fp, Rb^Gvs, Gg, Rb^Gvs, Rb^Gvs, Rb^Gvs, Rb, Rb, Rb^Gvs, Rb^Gvs, Rb^Gvs, Rb, Rb^Gvs, Rb^Gvs, Gg, Gg, Hh, Hh
Gll^Fp, Gll^Fp, Gg, Gll^Fp, Re, Gs, Gll^Fp, Gs, Gll^Fp, Gll^Fp, Gll^Fp, Gg, Re, Gg, Ww, Gll^Fp, Gll^Fp, Ww, Ww, Gg, Gs, Gll^Fp, Gll^Fp, Gs, Gs, Gg, Rb^Gvs, Rb^Gvs, Rb, Rb^Gvs, Rb^Gvs, Rb^Gvs, Re^Gvs, Rb^Gvs, Gg, Rb^Gvs, Hh, Hh, Hh, Hh
Gll^Fp, Gll^Fp, Gll^Fp, Gll^Fp, Re, Gll^Fp, Gll^Fp, Gll^Fp, Gs, Gll^Fp, Gll^Fp, Gg^Vo, Re, Gg, Ww, Gll^Fp, Gll^Fp, Gll^Fp, Ww, Gg, Gg, Gll^Fp, Gs, Gs, Gg, Gg, Rb^Gvs, Rb^Gvs, Rb, Rb^Gvs, Re^Gvs, Re^Gvs, Re^Gvs, Re^Gvs, Re^Gvs, Gg, Hh, Hh, Hh, Hh
Gll^Fp, Gll^Fp, Gll^Fp, Gll^Fp, Re, Gll^Fp, Gll^Fp, Gs, Gll^Fp, Gs, Re, Re, Gg, Ww^Bw\, Gg, Gg, Gll^Fp, Gll^Fp, Ww, Gg, Gg, Gg, Gs, Gs, Gg^Vo, Rb^Gvs, Re^Gvs, Rb^Gvs, Re, Re, Re, Re, Re, Re^Gvs, Re^Gvs, Re^Gvs, Hh, Hh, Hh, Hh
Gll^Fp, Gll^Fp, Gll^Fp, Re, Gll^Fp, Gll^Fp, Gll^Fp, Gll^Fp, Gs, Re, Gg, Gg, Ww, Ww, Gg, Gg, Gg, Gll^Fp, Gg, Gg, Gs, Gs, Gll^Fp, Gll^Fp, Re^Gvs, Re^Gvs, Re, Re, Re^Gvs, Re^Gvs, Re^Gvs, Re^Gvs, Re^Gvs, Re, Hh, Hh, Hh, Hh, Mm, Mm
Gll^Fp, Gll^Fp, Gll^Fp, Re, Gll^Fp, Gll^Fp, Gll^Fp, Gll^Fp, Gll^Fp, Re, Gg, Ww, Ww, Gg, Gs, Gg, Gs, Gg, Gg, Gg, Gll^Fp, Gll^Fp, Gs, Gll^Fp, Re^Gvs, Re^Gvs, Re, Re^Gvs, Re^Gvs, Re^Gvs, Re^Gvs, Re^Gvs, Re^Gvs, Hh, Hh, Hh, Mm, Hh, Mm, Mm
Gll^Fp, Gll^Fp, Gll^Fp, Re, Re, Gll^Fp, Gll^Fp, Gll^Fp, Gll^Fp, Re, Gg, Ww, Gg, Gg, Gs, Gg, Gs, Gd^Vo, Gg, Gg, Gll^Fp, Gll^Fp, Gs, Gs, Gs, Re, Re, Re^Gvs, Hh, Gs, Gs, Gs, Gs, Hh, Hh, Mm, Mm, Mm, Mm, Mm
Gll^Fp, Gll^Fp, Gll^Fp, Gll^Fp, Gll^Fp, Re, Re, Re, Re, Re, Gg, Ww, Gg, Gll^Fp, Gll^Fp, Gs, Gs, Gs, Gs, Gs, Gs, Gs, Gs, Gs, Gs, Gs, Re, Hh, Hh, Hh, Hh, Gs, Hh, Hh, Hh, Hh, Hh, Mm, Mm, Mm
Gll^Fp, Gll^Fp, Gll^Fp, Gll^Fp, Gll^Fp, Gll^Fp, Gll^Fp, Gs, Gs, Gg, Gg, Ww, Ww, Gll^Fp, Gll^Fp, Gll^Fp, Gll^Fp, Gs, Gs, Gs, Gg, Gg, Gg, Gs, Re, Re, Gs, Gs, Hh, Hh, Hh, Hh, Hh, Hh, Hh, Hh, Hh, Hh, Mm, Mm
Gll^Fp, Gll^Fp, Gll^Fp, Gll^Fp, Gll^Fp, Gll^Fp, Gg^Ve, Gll^Fp, Gg, Gg, Ww, Ww, Gg, Gs, Gs, Gll^Fp, Gs, Gs, Gs, Gg, Gg, Gs, Gs, Gs^Vo, Re, Gs, Gs, Hh, Hh, Hh^Vc, Hh, Hh, Hh, Hh, Mm, Mm^Vc, Mm, Mm, Mm, Mm
Gg, Gg^Ve, Gg, Gll^Fp, Gll^Fp, Gll^Fp, Gs, Gs, Gg, Gll^Fp, Ww, Ww, Gg, Gg, Gs, Gll^Fp, Gs, Gs, Gs, Gg, Gs, Gs, Re, Re, Gs, Gs, Gs, Hh, Hh, Hh, Hh, Hh, Mm, Mm, Mm, Mm, Mm, Mm, Mm, Mm
Gg, Gg, Gg, Gll^Fp, Gll^Fp, Gll^Fp, Gs, Gg, Gs, Gll^Fp, Ww, Ww, Gg, Gs, Gs, Gll^Fp, Gs, Gs, Gs, Gs, Gs, Gs, Re, Re, Gs, Gs, Hh, Hh, Hh, Hh, Hh, Hh, Mm, Mm, Mm, Mm, Mm, Mm, Mm, Mm
